,d,Geographic Area N,Total,Male,Female,Total Under 18 year,Male Under 18 year,Female Under 18 year,Total 60 years and over,Male 60 years and over,Female 60 years and over,Median age (years),Sex ratio (males per 100 females),Age dependency ratio,Old-age dependency ratio,Child dependency ratio,county_state_name,full_county_fips,percent_under18,percent_over60,COUNTYFIPS,hospital_bed_count,hospital_count
0,0500000US01117,"Shelby County, Alabama",215707,105022,110685,48670,25382,23288,47098,21899,25199,40.4,94.9,61.3,24.9,36.4,"Shelby County, Alabama",01117,22.563013717681855,21.834247381865215,01117,349.0,3.0
1,0500000US01121,"Talladega County, Alabama",79828,38489,41339,16810,8292,8518,20479,8991,11488,41.5,93.1,64.3,29.7,34.6,"Talladega County, Alabama",01121,21.057774214561306,25.653905897680012,01121,285.0,2.0
2,0500000US01125,"Tuscaloosa County, Alabama",208911,99576,109335,43992,21652,22340,39432,18110,21322,33.0,91.1,52.0,20.0,32.0,"Tuscaloosa County, Alabama",01125,21.05777101253644,18.875023335295893,01125,933.0,4.0
3,0500000US04021,"Pinal County, Arizona",447138,233292,213846,101143,52140,49003,118634,56331,62303,39.8,109.1,75.2,35.6,39.6,"Pinal County, Arizona",04021,22.620085968984966,26.53185370064723,04021,249.0,3.0
4,0500000US06045,"Mendocino County, California",87606,43017,44589,18535,9033,9502,25968,12178,13790,42.9,96.5,75.2,38.1,37.1,"Mendocino County, California",06045,21.1572266739721,29.641805355797544,06045,141.0,3.0
5,0500000US06059,"Orange County, California",3185968,1573189,1612779,698786,357863,340923,659502,300043,359459,38.3,97.5,58.0,23.4,34.7,"Orange County, California",06059,21.933239756331513,20.70020791169277,06059,8444.0,41.0
6,0500000US06067,"Sacramento County, California",1540975,752842,788133,363911,185405,178506,310577,138464,172113,36.4,95.5,60.6,22.7,37.9,"Sacramento County, California",06067,23.61563295965217,20.154577459076233,06067,4159.0,18.0
7,0500000US12017,"Citrus County, Florida",147929,72104,75825,21949,10741,11208,68279,32959,35320,57.2,95.1,105.0,74.6,30.4,"Citrus County, Florida",12017,14.837523406499065,46.15660215373592,12017,332.0,2.0
8,0500000US17143,"Peoria County, Illinois",180621,87818,92803,42559,21480,21079,42897,19618,23279,38.0,94.6,67.5,28.0,39.5,"Peoria County, Illinois",17143,23.562597926044038,23.749730097829154,17143,1122.0,4.0
9,0500000US18059,"Hancock County, Indiana",76351,37401,38950,17780,8866,8914,17026,8040,8986,38.8,96.0,67.4,28.4,39.0,"Hancock County, Indiana",18059,23.287186808293278,22.29964244083247,18059,68.0,1.0
10,0500000US18067,"Howard County, Indiana",82366,39675,42691,18632,9553,9079,21163,9393,11770,42.1,92.9,72.3,33.3,39.0,"Howard County, Indiana",18067,22.620984386761528,25.69385426025302,18067,254.0,3.0
11,0500000US22105,"Tangipahoa Parish, Louisiana",133777,65151,68626,32871,16920,15951,26868,11903,14965,36.3,94.9,63.5,23.3,40.2,"Tangipahoa Parish, Louisiana",22105,24.571488372440704,20.084169924575974,22105,424.0,9.0
12,0500000US25003,"Berkshire County, Massachusetts",126348,61499,64849,21564,11413,10151,39858,17889,21969,47.3,94.8,67.2,38.7,28.5,"Berkshire County, Massachusetts",25003,17.06714787729129,31.546205717542026,25003,359.0,3.0
13,0500000US27139,"Scott County, Minnesota",147381,72552,74829,40100,20118,19982,23675,10252,13423,37.0,97.0,62.0,17.9,44.1,"Scott County, Minnesota",27139,27.208391855123793,16.063807410724586,27139,142.0,2.0
14,0500000US36087,"Rockland County, New York",325695,160230,165465,91712,47212,44500,70767,31462,39305,35.9,96.8,78.1,27.9,50.2,"Rockland County, New York",36087,28.15886028339397,21.727997052457056,36087,1169.0,4.0
15,0500000US36105,"Sullivan County, New York",75498,38858,36640,16002,8306,7696,19409,9530,9879,42.7,106.1,66.7,31.3,35.3,"Sullivan County, New York",36105,21.195263450687435,25.70796577392779,36105,169.0,2.0
16,0500000US37037,"Chatham County, North Carolina",73139,35221,37918,14993,7639,7354,23235,10858,12377,46.9,92.9,81.6,44.4,37.2,"Chatham County, North Carolina",37037,20.499323206497216,31.76827684272413,37037,25.0,1.0
17,0500000US37085,"Harnett County, North Carolina",134214,66838,67376,34930,18208,16722,23720,10832,12888,34.9,99.2,63.2,20.7,42.5,"Harnett County, North Carolina",37085,26.025600906015768,17.67326806443441,37085,167.0,2.0
18,0500000US37195,"Wilson County, North Carolina",81455,37267,44188,18683,8422,10261,20750,9148,11602,40.7,84.3,69.8,30.9,38.9,"Wilson County, North Carolina",37195,22.936590755631943,25.474188202074764,37195,317.0,1.0
19,0500000US39007,"Ashtabula County, Ohio",97493,49312,48181,21423,11309,10114,26501,11863,14638,43.1,102.3,69.6,32.3,37.3,"Ashtabula County, Ohio",39007,21.97388530458597,27.182464382058196,39007,429.0,5.0
20,0500000US39013,"Belmont County, Ohio",67505,34519,32986,13271,6702,6569,20088,9204,10884,45.1,104.6,69.3,36.0,33.3,"Belmont County, Ohio",39013,19.659284497444634,29.757795718835645,39013,300.0,4.0
21,0500000US40031,"Comanche County, Oklahoma",120422,62558,57864,28335,14241,14094,22390,9890,12500,33.3,108.1,56.7,19.8,36.9,"Comanche County, Oklahoma",40031,23.529753699490126,18.59294813240106,40031,538.0,4.0
22,0500000US42013,"Blair County, Pennsylvania",122492,59228,63264,24260,12349,11911,33697,14922,18775,44.0,93.6,68.4,35.0,33.4,"Blair County, Pennsylvania",42013,19.80537504490089,27.509551644189006,42013,598.0,5.0
23,0500000US42039,"Crawford County, Pennsylvania",85063,41603,43460,17737,9009,8728,24165,11317,12848,43.2,95.7,70.9,35.3,35.6,"Crawford County, Pennsylvania",42039,20.85160410519262,28.408356159552334,42039,289.0,2.0
24,0500000US42051,"Fayette County, Pennsylvania",130441,64372,66069,24914,12468,12446,38235,17404,20831,45.1,97.4,67.6,35.6,32.0,"Fayette County, Pennsylvania",42051,19.099822908441364,29.31210278976702,42051,283.0,2.0
25,0500000US47113,"Madison County, Tennessee",97605,46509,51096,21894,11490,10404,23882,10574,13308,38.7,91.0,65.1,28.0,37.0,"Madison County, Tennessee",47113,22.43122790840633,24.468008811024024,47113,835.0,3.0
26,0500000US48027,"Bell County, Texas",355642,177081,178561,98693,50653,48040,54161,24038,30123,30.9,99.2,62.9,17.7,45.2,"Bell County, Texas",48027,27.75065937094044,15.229078680245864,48027,1091.0,7.0
27,0500000US48061,"Cameron County, Texas",423908,206053,217855,128762,65717,63045,75340,32776,42564,32.4,94.6,78.8,24.5,54.3,"Cameron County, Texas",48061,30.37498702548666,17.77272427036055,48061,1519.0,10.0
28,0500000US49057,"Weber County, Utah",256359,128298,128061,72520,36502,36018,42591,19111,23480,33.2,100.2,66.2,19.2,47.0,"Weber County, Utah",49057,28.288454862126937,16.613811100839058,49057,477.0,2.0
29,0500000US51165,"Rockingham County, Virginia",81244,39572,41672,17790,8959,8831,21600,9774,11826,41.1,95.0,68.4,31.5,36.9,"Rockingham County, Virginia",51165,21.897001624735367,26.586578701196395,51165,238.0,1.0
30,0500000US51700,"Newport News city, Virginia",178626,87141,91485,41278,21898,19380,34393,15972,18421,33.8,95.3,56.8,20.6,36.2,"Newport News city, Virginia",51700,23.108618006337263,19.254195917727543,51700,792.0,5.0
31,0500000US51710,"Norfolk city, Virginia",244076,127098,116978,47774,24163,23611,40557,17829,22728,30.7,108.7,44.4,16.1,28.3,"Norfolk city, Virginia",51710,19.573411560333668,16.616545666104003,51710,1400.0,7.0
32,0500000US51810,"Virginia Beach city, Virginia",450189,221277,228912,99439,50955,48484,90171,39206,50965,36.5,96.7,56.9,22.3,34.7,"Virginia Beach city, Virginia",51810,22.088278478594546,20.02958757321925,51810,700.0,4.0
33,0500000US53007,"Chelan County, Washington",77036,38586,38450,18053,9050,9003,19243,9282,9961,39.2,100.4,72.9,32.4,40.5,"Chelan County, Washington",53007,23.434498156705956,24.979230489641207,53007,251.0,4.0
34,0500000US01015,"Calhoun County, Alabama",114277,55054,59223,24484,12399,12085,28370,12107,16263,40.1,93.0,65.0,29.6,35.3,"Calhoun County, Alabama",01015,21.42513366644207,24.82564295527534,01015,590.0,4.0
35,0500000US08005,"Arapahoe County, Colorado",651215,323168,328047,152661,78200,74461,123453,56197,67256,36.9,98.5,57.5,20.6,36.9,"Arapahoe County, Colorado",08005,23.442488271922485,18.95733359950247,08005,1018.0,7.0
36,0500000US13013,"Barrow County, Georgia",80809,39917,40892,20961,11313,9648,14226,6251,7975,36.3,97.6,62.9,20.6,42.3,"Barrow County, Georgia",13013,25.938942444529694,17.60447474909973,13013,56.0,1.0
37,0500000US13157,"Jackson County, Georgia",70422,34762,35660,17896,9132,8764,13979,6708,7271,38.3,97.5,66.6,24.2,42.3,"Jackson County, Georgia",13157,25.41251313509983,19.850330862514557,13157,257.0,1.0
38,0500000US13245,"Richmond County, Georgia",201554,96104,105450,45628,21787,23841,42346,17880,24466,34.4,91.1,57.7,22.0,35.7,"Richmond County, Georgia",13245,22.63810194786509,21.009754209789932,13245,2470.0,9.0
39,0500000US13285,"Troup County, Georgia",70034,32962,37072,17162,8440,8722,14772,6154,8618,36.4,88.9,63.6,23.5,40.1,"Troup County, Georgia",13285,24.50524031184853,21.092612159808095,13285,276.0,1.0
40,0500000US19061,"Dubuque County, Iowa",96854,47876,48978,21527,10392,11135,23860,10798,13062,38.4,97.8,67.3,30.1,37.2,"Dubuque County, Iowa",19061,22.22623742953311,24.635017655440148,19061,470.0,3.0
41,0500000US21227,"Warren County, Kentucky",131264,64686,66578,30077,15410,14667,23899,10291,13608,33.0,97.2,56.6,20.7,35.9,"Warren County, Kentucky",21227,22.913365431496832,18.206819843978547,21227,733.0,4.0
42,0500000US27019,"Carver County, Minnesota",103551,50636,52915,27756,13837,13919,18200,8199,10001,38.1,95.7,64.1,20.1,44.0,"Carver County, Minnesota",27019,26.80418344583828,17.57588048401271,27019,109.0,1.0
43,0500000US28075,"Lauderdale County, Mississippi",75317,36101,39216,17728,8545,9183,17239,7847,9392,37.4,92.1,68.7,29.0,39.7,"Lauderdale County, Mississippi",28075,23.537846701275942,22.888590889175088,28075,988.0,7.0
44,0500000US28081,"Lee County, Mississippi",85202,41053,44149,20753,10414,10339,17917,7614,10303,37.1,93.0,62.7,23.1,39.6,"Lee County, Mississippi",28081,24.357409450482383,21.028849088049576,28081,700.0,2.0
45,0500000US28121,"Rankin County, Mississippi",153902,74616,79286,35671,18570,17101,32059,13816,18243,38.0,94.1,62.4,24.8,37.6,"Rankin County, Mississippi",28121,23.177736481657156,20.83078842380216,28121,2081.0,7.0
46,0500000US36111,"Ulster County, New York",178599,88542,90057,31311,15602,15709,49420,22680,26740,43.3,98.3,59.2,31.3,27.9,"Ulster County, New York",36111,17.53145314363462,27.670927608777205,36111,325.0,3.0
47,0500000US37183,"Wake County, North Carolina",1092305,531608,560697,261532,132966,128566,182863,81397,101466,36.4,94.8,55.2,18.0,37.2,"Wake County, North Carolina",37183,23.943129437290867,16.741020136317236,37183,1781.0,5.0
48,0500000US39093,"Lorain County, Ohio",309461,152537,156924,68263,35350,32913,79585,35411,44174,42.1,97.2,67.9,30.9,37.0,"Lorain County, Ohio",39093,22.058676214450287,25.717295555821252,39093,840.0,5.0
49,0500000US40119,"Payne County, Oklahoma",82040,42030,40010,16208,8266,7942,14821,6718,8103,27.8,105.0,49.6,20.0,29.5,"Payne County, Oklahoma",40119,19.756216479765968,18.065577766942955,40119,216.0,2.0
50,0500000US40131,"Rogers County, Oklahoma",91984,45795,46189,21479,11016,10463,20639,9534,11105,39.7,99.1,65.7,27.0,38.7,"Rogers County, Oklahoma",40131,23.350800139154636,22.43759784310315,40131,81.0,1.0
51,0500000US42081,"Lycoming County, Pennsylvania",113664,54669,58995,23317,11172,12145,30539,13876,16663,41.7,92.7,66.1,32.0,34.1,"Lycoming County, Pennsylvania",42081,20.51397100225225,26.867785754504503,42081,302.0,4.0
53,0500000US45085,"Sumter County, South Carolina",106512,51530,54982,25144,13127,12017,23793,10705,13088,36.7,93.7,66.9,27.5,39.4,"Sumter County, South Carolina",45085,23.606729758149317,22.33832807570978,45085,283.0,1.0
54,0500000US47147,"Robertson County, Tennessee",71012,34958,36054,16931,8460,8471,14932,6956,7976,39.2,97.0,61.6,23.0,38.5,"Robertson County, Tennessee",47147,23.84244916352166,21.02743198332676,47147,109.0,1.0
55,0500000US48085,"Collin County, Texas",1005146,494709,510437,260477,132804,127673,159747,72207,87540,37.2,96.9,58.5,17.4,41.1,"Collin County, Texas",48085,25.914344781753094,15.892915059105842,48085,2665.0,28.0
56,0500000US49045,"Tooele County, Utah",69907,35716,34191,22890,11950,10940,10681,5154,5527,31.6,104.5,71.9,15.6,56.3,"Tooele County, Utah",49045,32.743502081336636,15.278870499377744,49045,31.0,1.0
57,0500000US53041,"Lewis County, Washington",79604,39969,39635,16999,8960,8039,23303,10885,12418,43.4,100.8,73.0,36.0,36.9,"Lewis County, Washington",53041,21.354454550022613,29.273654590221597,53041,125.0,2.0
58,0500000US53053,"Pierce County, Washington",891299,443778,447521,209271,107420,101851,176887,82272,94615,36.4,99.2,59.5,22.1,37.5,"Pierce County, Washington",53053,23.479326241811112,19.84597761245104,53053,2538.0,12.0
59,0500000US54061,"Monongalia County, West Virginia",106420,55123,51297,17697,9458,8239,19179,9169,10010,32.4,107.5,40.9,17.4,23.4,"Monongalia County, West Virginia",54061,16.629392971246006,18.021988348054876,54061,940.0,3.0
60,0500000US55009,"Brown County, Wisconsin",263378,131002,132376,62704,32043,30661,55808,26408,29400,38.1,99.0,63.3,24.4,38.9,"Brown County, Wisconsin",55009,23.80760731723986,21.18931725504788,55009,1278.0,8.0
61,0500000US06115,"Yuba County, California",78041,39819,38222,21261,11356,9905,14990,6912,8078,33.8,104.2,64.7,19.8,44.9,"Yuba County, California",06115,27.243372073653592,19.20785228277444,06115,173.0,1.0
62,0500000US13051,"Chatham County, Georgia",289195,139000,150195,61165,31248,29917,60778,25846,34932,36.0,92.5,57.3,24.0,33.3,"Chatham County, Georgia",13051,21.15008904026695,21.016269299261744,13051,1717.0,9.0
63,0500000US13063,"Clayton County, Georgia",289615,135117,154498,80557,40366,40191,41115,17568,23547,32.4,87.5,59.0,14.8,44.2,"Clayton County, Georgia",13063,27.815202941836574,14.196433195794416,13063,558.0,4.0
64,0500000US13113,"Fayette County, Georgia",113459,55380,58079,26094,13833,12261,27937,12679,15258,43.5,95.4,69.1,30.2,38.9,"Fayette County, Georgia",13113,22.998616240227747,24.62299156523502,13113,157.0,1.0
65,0500000US13223,"Paulding County, Georgia",164044,79993,84051,43620,21897,21723,24743,10770,13973,35.9,95.2,58.4,16.3,42.1,"Paulding County, Georgia",13223,26.590426958620856,15.08314842359367,13223,299.0,2.0
66,0500000US17043,"DuPage County, Illinois",928589,456716,471873,210579,108381,102198,207758,94918,112840,39.5,96.8,61.7,25.0,36.7,"DuPage County, Illinois",17043,22.677309337069467,22.373515085791453,17043,1880.0,7.0
67,0500000US17089,"Kane County, Illinois",534216,266324,267892,135996,69860,66136,102960,47771,55189,37.7,99.4,64.3,22.5,41.8,"Kane County, Illinois",17089,25.457118468933913,19.273103014510983,17089,1101.0,5.0
68,0500000US18089,"Lake County, Indiana",484411,234684,249727,113030,57884,55146,113549,50384,63165,39.1,94.0,66.2,27.4,38.8,"Lake County, Indiana",18089,23.333491601140356,23.440632025284312,18089,2605.0,14.0
69,0500000US21059,"Daviess County, Kentucky",101104,49475,51629,24701,12803,11898,23802,10601,13201,38.0,95.8,70.3,28.7,41.6,"Daviess County, Kentucky",21059,24.43127868333597,23.542095268238644,21059,527.0,2.0
70,0500000US21185,"Oldham County, Kentucky",66470,34749,31721,17124,8242,8882,12881,6097,6784,39.2,109.5,63.3,21.3,42.1,"Oldham County, Kentucky",21185,25.76199789378667,19.37866706785016,21185,187.0,2.0
71,0500000US25009,"Essex County, Massachusetts",790638,381869,408769,168346,86092,82254,186975,82713,104262,41.1,93.4,62.2,27.7,34.5,"Essex County, Massachusetts",25009,21.292424598868255,23.648623010783695,25009,1443.0,14.0
72,0500000US26163,"Wayne County, Michigan",1753893,844941,908952,414230,211644,202586,386924,170135,216789,38.1,93.0,64.0,25.3,38.7,"Wayne County, Michigan",26163,23.61774635054704,22.06086688298545,26163,6079.0,27.0
73,0500000US29165,"Platte County, Missouri",102985,50777,52208,24332,12858,11474,21196,10262,10934,38.1,97.3,61.9,23.6,38.2,"Platte County, Missouri",29165,23.626741758508523,20.581638102636308,29165,97.0,1.0
74,0500000US36053,"Madison County, New York",70795,34819,35976,13477,6680,6797,18851,9167,9684,42.4,96.8,60.1,29.6,30.5,"Madison County, New York",36053,19.036655131012076,26.627586693975562,36053,126.0,2.0
75,0500000US37159,"Rowan County, North Carolina",141262,71297,69965,31435,18255,13180,32944,14620,18324,40.3,101.9,65.7,28.9,36.9,"Rowan County, North Carolina",37159,22.252976738259406,23.321204570231203,37159,268.0,1.0
76,0500000US39029,"Columbiana County, Ohio",102665,51589,51076,20872,10222,10650,29161,13403,15758,44.4,101.0,69.4,34.9,34.4,"Columbiana County, Ohio",39029,20.330200165587105,28.404032532995664,39029,351.0,2.0
77,0500000US41059,"Umatilla County, Oregon",77516,39788,37728,19889,9447,10442,16703,8076,8627,37.2,105.5,69.6,26.1,43.5,"Umatilla County, Oregon",41059,25.657928685690695,21.547809484493524,41059,539.0,4.0
78,0500000US42045,"Delaware County, Pennsylvania",564751,272087,292664,123763,63560,60203,128930,56885,72045,39.0,93.0,62.0,26.5,35.5,"Delaware County, Pennsylvania",42045,21.914613697009834,22.829530182328142,42045,1162.0,6.0
79,0500000US42073,"Lawrence County, Pennsylvania",86184,41919,44265,16795,8554,8241,26361,11812,14549,45.5,94.7,71.0,37.6,33.3,"Lawrence County, Pennsylvania",42073,19.48737584702497,30.58688387635756,42073,316.0,2.0
80,0500000US47157,"Shelby County, Tennessee",935764,445278,490486,233189,118335,114854,191123,82531,108592,36.0,90.8,62.6,22.1,40.5,"Shelby County, Tennessee",47157,24.919637857408492,20.42427364164469,47157,5491.0,23.0
81,0500000US04003,"Cochise County, Arizona",126770,64995,61775,27247,14015,13232,38672,18794,19878,41.0,105.2,78.2,39.9,38.3,"Cochise County, Arizona",04003,21.4932555020904,30.505640135678792,04003,267.0,5.0
82,0500000US04005,"Coconino County, Arizona",142854,70521,72333,29455,15138,14317,25698,12494,13204,30.8,97.5,49.5,18.6,30.8,"Coconino County, Arizona",04005,20.618953616979574,17.98899575790667,04005,308.0,3.0
83,0500000US06023,"Humboldt County, California",136373,68722,67651,26135,14056,12079,35287,16721,18566,38.5,101.6,58.7,28.3,30.4,"Humboldt County, California",06023,19.164350714584266,25.875356558849628,06023,299.0,6.0
84,0500000US06039,"Madera County, California",157672,76573,81099,43123,21454,21669,30154,14381,15773,34.3,94.4,70.5,23.9,46.6,"Madera County, California",06039,27.34981480541884,19.124511644426402,06039,462.0,2.0
85,0500000US12097,"Osceola County, Florida",367990,179155,188835,89970,43737,46233,69040,30650,38390,35.7,94.9,60.3,21.1,39.2,"Osceola County, Florida",12097,24.449033941139707,18.761379385309386,12097,997.0,6.0
86,0500000US13059,"Clarke County, Georgia",127330,61122,66208,21439,11358,10081,20634,9181,11453,28.2,92.3,40.1,16.5,23.6,"Clarke County, Georgia",13059,16.83735176313516,16.205136260111523,13059,574.0,3.0
87,0500000US13313,"Whitfield County, Georgia",104062,51621,52441,27387,14238,13149,20054,8657,11397,37.0,98.4,67.6,23.5,44.1,"Whitfield County, Georgia",13313,26.317964290519114,19.27120370548327,13313,282.0,1.0
88,0500000US16019,"Bonneville County, Idaho",116854,58838,58016,36116,18680,17436,20981,9766,11215,33.4,101.4,77.9,22.9,55.0,"Bonneville County, Idaho",16019,30.906943707532474,17.954883872182382,16019,332.0,2.0
89,0500000US22109,"Terrebonne Parish, Louisiana",111021,53314,57707,28293,14245,14048,23036,10398,12638,36.1,92.4,68.0,25.2,42.8,"Terrebonne Parish, Louisiana",22109,25.484367822303888,20.749227623602742,22109,367.0,4.0
90,0500000US24015,"Cecil County, Maryland",102826,50795,52031,23118,11733,11385,24987,11344,13643,41.3,97.6,61.9,25.5,36.4,"Cecil County, Maryland",24015,22.4826405772859,24.30027424970338,24015,122.0,1.0
91,0500000US24037,"St. Mary's County, Maryland",112664,55523,57141,27201,13546,13655,21778,10504,11274,37.5,97.2,59.9,21.3,38.6,"St. Mary's County, Maryland",24037,24.1434708513811,19.330043314634665,24037,95.0,1.0
92,0500000US25001,"Barnstable County, Massachusetts",213413,101183,112230,32580,16611,15969,84127,36902,47225,53.8,90.2,85.0,56.7,28.2,"Barnstable County, Massachusetts",25001,15.266174038132634,39.419810414548316,25001,407.0,3.0
93,0500000US25021,"Norfolk County, Massachusetts",705388,338835,366553,147526,74926,72600,165458,72778,92680,40.7,92.4,60.7,27.1,33.6,"Norfolk County, Massachusetts",25021,20.914163552541297,23.456310569502175,25021,1786.0,12.0
94,0500000US27163,"Washington County, Minnesota",259201,128302,130899,63648,32419,31229,54325,25056,29269,39.6,98.0,65.3,24.7,40.6,"Washington County, Minnesota",27163,24.555460819981402,20.958638276858498,27163,183.0,2.0
95,0500000US34033,"Salem County, New Jersey",62607,30819,31788,13607,7444,6163,16661,7820,8841,41.6,97.0,68.0,31.5,36.5,"Salem County, New Jersey",34033,21.73399140671171,26.612040187199515,34033,222.0,2.0
96,0500000US34035,"Somerset County, New Jersey",331164,161936,169228,72516,37261,35255,76048,34182,41866,41.7,95.7,60.0,24.9,35.0,"Somerset County, New Jersey",34035,21.897307678370836,22.96384872751869,34035,759.0,4.0
97,0500000US36081,"Queens County, New York",2278906,1105577,1173329,458368,234957,223411,499303,216004,283299,39.2,94.2,55.8,24.4,31.3,"Queens County, New York",36081,20.113510605527388,21.909767230416698,36081,3734.0,9.0
98,0500000US36119,"Westchester County, New York",967612,468837,498775,211845,109402,102443,228317,98942,129375,40.9,94.0,63.9,28.0,35.9,"Westchester County, New York",36119,21.89358957929418,23.595924812838202,36119,3235.0,17.0
99,0500000US37109,"Lincoln County, North Carolina",83770,41363,42407,17649,9077,8572,19646,9102,10544,44.7,97.5,61.6,27.5,34.0,"Lincoln County, North Carolina",37109,21.068401575743106,23.452309896144204,37109,101.0,1.0
100,0500000US42003,"Allegheny County, Pennsylvania",1218452,588659,629793,227749,116071,111678,320662,140250,180412,40.5,93.5,60.2,30.2,29.9,"Allegheny County, Pennsylvania",42003,18.691667788308443,26.317163088902966,42003,7775.0,30.0
101,0500000US45035,"Dorchester County, South Carolina",160647,78351,82296,39214,20360,18854,31436,13891,17545,37.4,95.2,62.3,22.7,39.6,"Dorchester County, South Carolina",45035,24.410041893094796,19.56837040218616,45035,104.0,2.0
102,0500000US48231,"Hunt County, Texas",96493,47884,48609,23048,12056,10992,22077,10462,11615,38.8,98.5,64.5,25.2,39.3,"Hunt County, Texas",48231,23.885670463142404,22.879379851388183,48231,271.0,3.0
103,0500000US51650,"Hampton city, Virginia",134313,64444,69869,27543,13835,13708,28622,12026,16596,36.6,92.2,56.0,24.0,32.0,"Hampton city, Virginia",51650,20.506577918742042,21.309925323684233,51650,812.0,3.0
104,0500000US01077,"Lauderdale County, Alabama",92387,45646,46741,17876,10400,7476,24132,10908,13224,41.1,97.7,64.7,32.8,31.9,"Lauderdale County, Alabama",01077,19.349042614220615,26.120558087176764,01077,358.0,1.0
105,0500000US09011,"New London County, Connecticut",266784,133585,133199,51733,26266,25467,68253,32650,35603,42.4,100.3,60.0,29.0,31.0,"New London County, Connecticut",09011,19.391342809163966,25.583618207988483,09011,465.0,2.0
106,0500000US17167,"Sangamon County, Illinois",195348,94821,100527,43207,22756,20451,48685,21485,27200,40.7,94.3,66.3,29.5,36.8,"Sangamon County, Illinois",17167,22.117963838892642,24.922190142719657,17167,1045.0,4.0
107,0500000US21111,"Jefferson County, Kentucky",770517,372347,398170,170794,87228,83566,175637,76045,99592,38.6,93.5,62.1,26.2,35.9,"Jefferson County, Kentucky",21111,22.166155970601555,22.794694990506375,21111,4795.0,16.0
108,0500000US21151,"Madison County, Kentucky",92368,45221,47147,18481,9337,9144,17701,8220,9481,34.5,95.9,51.0,20.8,30.2,"Madison County, Kentucky",21151,20.008011432530747,19.16356313874935,21151,130.0,2.0
109,0500000US22015,"Bossier Parish, Louisiana",127185,62135,65050,31590,15688,15902,24787,11140,13647,35.4,95.5,63.1,22.6,40.5,"Bossier Parish, Louisiana",22015,24.837834650312537,19.488933443409206,22015,404.0,4.0
110,0500000US24009,"Calvert County, Maryland",92003,46221,45782,21300,11624,9676,19606,9219,10387,40.4,101.0,60.8,23.5,37.2,"Calvert County, Maryland",24009,23.15141897546819,21.310174668217343,24009,76.0,1.0
111,0500000US26025,"Calhoun County, Michigan",134487,66126,68361,30702,16253,14449,33975,15694,18281,40.4,96.7,68.7,30.2,38.5,"Calhoun County, Michigan",26025,22.828972317026924,25.262664792879608,26025,317.0,4.0
112,0500000US34025,"Monmouth County, New Jersey",621354,302643,318711,131726,67419,64307,155312,71017,84295,43.6,95.0,63.3,28.7,34.6,"Monmouth County, New Jersey",34025,21.19983133608217,24.995735120398354,34025,2176.0,7.0
113,0500000US37119,"Mecklenburg County, North Carolina",1093901,526422,567479,257714,130801,126913,179491,78588,100903,35.2,92.8,53.3,17.2,36.1,"Mecklenburg County, North Carolina",37119,23.559170345396886,16.408340425687516,37119,2949.0,13.0
114,0500000US39055,"Geauga County, Ohio",94031,46724,47307,21318,10816,10502,26680,12636,14044,44.9,98.8,76.7,36.7,40.1,"Geauga County, Ohio",39055,22.671246716508385,28.373621465261458,39055,281.0,2.0
115,0500000US39119,"Muskingum County, Ohio",86183,42143,44040,19683,10009,9674,21919,9924,11995,40.9,95.7,68.0,29.6,38.4,"Muskingum County, Ohio",39119,22.838610862931205,25.43309005256257,39119,592.0,2.0
116,0500000US41043,"Linn County, Oregon",127335,62661,64674,27940,14429,13511,32079,15233,16846,39.8,96.9,70.2,32.9,37.3,"Linn County, Oregon",41043,21.942121176424394,25.192602191070794,41043,98.0,2.0
117,0500000US42017,"Bucks County, Pennsylvania",628195,308124,320071,128214,65392,62822,162101,74747,87354,44.0,96.3,64.1,30.6,33.5,"Bucks County, Pennsylvania",42017,20.409904567849154,25.804248680744035,42017,1299.0,9.0
118,0500000US42095,"Northampton County, Pennsylvania",304807,149975,154832,60924,31524,29400,76871,34357,42514,42.4,96.9,63.7,31.0,32.7,"Northampton County, Pennsylvania",42095,19.987729940585357,25.21956516746663,42095,362.0,2.0
119,0500000US45075,"Orangeburg County, South Carolina",86934,40963,45971,18752,9419,9333,22804,9851,12953,39.4,89.1,69.4,32.9,36.5,"Orangeburg County, South Carolina",45075,21.57038673016311,26.231393931028137,45075,301.0,2.0
120,0500000US48029,"Bexar County, Texas",1986049,980600,1005449,508269,258385,249884,340969,149525,191444,33.8,97.5,60.5,19.4,41.1,"Bexar County, Texas",48029,25.59196676416342,17.168206826719786,48029,8104.0,45.0
121,0500000US48091,"Comal County, Texas",148373,73782,74591,33673,17464,16209,38636,18127,20509,40.7,98.9,68.1,30.0,38.2,"Comal County, Texas",48091,22.694829921886058,26.039778126748125,48091,348.0,5.0
122,0500000US48361,"Orange County, Texas",83572,41520,42052,20803,10958,9845,19473,8965,10508,38.4,98.7,69.1,27.0,42.1,"Orange County, Texas",48361,24.892308428660318,23.300866318862777,48361,94.0,1.0
123,0500000US48497,"Wise County, Texas",68305,34125,34180,16842,8523,8319,14871,7606,7265,37.9,99.8,65.0,24.3,40.7,"Wise County, Texas",48497,24.65705292438328,21.771466217700024,48497,184.0,3.0
124,0500000US53009,"Clallam County, Washington",76737,38390,38347,13075,6890,6185,28540,13031,15509,50.6,100.1,84.9,53.4,31.5,"Clallam County, Washington",53009,17.038716655589873,37.19196736906577,53009,163.0,2.0
125,0500000US04025,"Yavapai County, Arizona",231993,113011,118982,37293,19260,18033,95141,44962,50179,54.4,95.0,91.7,60.9,30.8,"Yavapai County, Arizona",04025,16.075053988697935,41.01028910355054,04025,332.0,4.0
126,0500000US13097,"Douglas County, Georgia",145331,69386,75945,37435,18861,18574,25119,11736,13383,36.8,91.4,60.4,19.1,41.3,"Douglas County, Georgia",13097,25.758441075888832,17.283993091632205,13097,192.0,2.0
127,0500000US13135,"Gwinnett County, Georgia",927781,452307,475474,248878,126103,122775,143352,64447,78905,35.5,95.1,58.5,16.0,42.5,"Gwinnett County, Georgia",13135,26.825080487744412,15.451060110090637,13135,847.0,5.0
128,0500000US15007,"Kauai County, Hawaii",72133,36483,35650,15680,8795,6885,20975,9761,11214,42.0,102.3,72.8,35.2,37.6,"Kauai County, Hawaii",15007,21.737623556485936,29.078230490898754,15007,144.0,2.0
129,0500000US16027,"Canyon County, Idaho",223499,110799,112700,62419,31815,30604,43574,19865,23709,34.4,98.3,73.1,24.7,48.3,"Canyon County, Idaho",16027,27.928089163709906,19.496284099705143,16027,302.0,2.0
130,0500000US18019,"Clark County, Indiana",117360,56839,60521,26544,13461,13083,26825,11848,14977,39.1,93.9,62.0,25.3,36.6,"Clark County, Indiana",18019,22.61758691206544,22.85702113156101,18019,442.0,4.0
131,0500000US19013,"Black Hawk County, Iowa",132408,65131,67277,28788,14714,14074,29365,13468,15897,35.2,96.8,60.7,25.7,34.9,"Black Hawk County, Iowa",19013,21.741888707630956,22.177662981088755,19013,459.0,3.0
132,0500000US21015,"Boone County, Kentucky",131533,65940,65593,33654,18311,15343,24630,11291,13339,38.2,100.5,63.4,21.6,41.8,"Boone County, Kentucky",21015,25.58597462233812,18.725338888339806,21015,201.0,2.0
133,0500000US22051,"Jefferson Parish, Louisiana",434051,209971,224080,95532,48334,47198,104642,45265,59377,39.7,93.7,64.2,28.1,36.1,"Jefferson Parish, Louisiana",22051,22.009395209318722,24.108226913427224,22051,1628.0,9.0
134,0500000US23031,"York County, Maine",206229,100163,106066,38788,20189,18599,59689,26684,33005,45.8,94.4,64.8,33.8,31.0,"York County, Maine",23031,18.808218048868007,28.943068142695743,23031,294.0,4.0
135,0500000US24027,"Howard County, Maryland",323196,157591,165605,78570,40185,38385,63880,29028,34852,39.2,95.2,61.7,22.4,39.3,"Howard County, Maryland",24027,24.310325622841866,19.765096102674537,24027,581.0,3.0
136,0500000US24031,"Montgomery County, Maryland",1052567,509380,543187,244087,124627,119460,229016,102506,126510,39.2,93.8,63.2,25.4,37.9,"Montgomery County, Maryland",24031,23.189687687339617,21.757854844394704,24031,1492.0,8.0
137,0500000US27053,"Hennepin County, Minnesota",1259428,623320,636108,276542,140502,136040,251746,113667,138079,36.5,98.0,56.3,21.9,34.3,"Hennepin County, Minnesota",27053,21.957745897343877,19.98891560295626,27053,4668.0,11.0
138,0500000US28067,"Jones County, Mississippi",68461,32862,35599,17031,8021,9010,17432,7827,9605,37.6,92.3,73.1,30.0,43.1,"Jones County, Mississippi",28067,24.8769372343378,25.462672178320506,28067,310.0,2.0
139,0500000US29510,"St. Louis city, Missouri",302838,146922,155916,57502,29155,28347,63541,28763,34778,36.4,94.2,48.7,20.5,28.2,"St. Louis city, Missouri",29510,18.987709600512485,20.981845078887062,29510,4324.0,12.0
140,0500000US34013,"Essex County, New Jersey",799767,384965,414802,188978,96383,92595,156065,66930,89135,37.8,92.8,59.2,21.6,37.6,"Essex County, New Jersey",34013,23.62913198469054,19.513808396695538,34013,4447.0,13.0
141,0500000US34021,"Mercer County, New Jersey",369811,180597,189214,78695,39943,38752,79032,35254,43778,38.9,95.4,57.3,23.8,33.5,"Mercer County, New Jersey",34021,21.279788865122995,21.370916495182673,34021,2058.0,10.0
142,0500000US36113,"Warren County, New York",64265,31907,32358,11357,5961,5396,20637,9896,10741,47.1,98.6,66.7,37.3,29.5,"Warren County, New York",36113,17.67213880028009,32.11234731191161,36113,410.0,1.0
143,0500000US36117,"Wayne County, New York",90064,44790,45274,19313,9879,9434,24219,11198,13021,44.0,98.9,68.5,32.3,36.1,"Wayne County, New York",36117,21.443640078166638,26.890877598152425,36117,120.0,1.0
144,0500000US37129,"New Hanover County, North Carolina",232274,112021,120253,41986,22490,19496,55769,24835,30934,39.3,93.2,56.1,27.9,28.2,"New Hanover County, North Carolina",37129,18.076065336628293,24.010005424627813,37129,769.0,1.0
145,0500000US39081,"Jefferson County, Ohio",65767,32354,33413,12485,6829,5656,19825,8897,10928,45.2,96.8,69.4,37.2,32.2,"Jefferson County, Ohio",39081,18.983684826736813,30.14429729195493,39081,560.0,4.0
146,0500000US42085,"Mercer County, Pennsylvania",110683,55089,55594,21247,11257,9990,32407,14501,17906,44.8,99.1,69.1,36.7,32.5,"Mercer County, Pennsylvania",42085,19.196263202117763,29.279112420154856,42085,521.0,4.0
147,0500000US42111,"Somerset County, Pennsylvania",73952,38433,35519,13094,6724,6370,22637,10543,12094,46.8,108.2,66.8,37.3,29.5,"Somerset County, Pennsylvania",42111,17.70607961921246,30.610395932496754,42111,224.0,3.0
148,0500000US51800,"Suffolk city, Virginia",91185,44445,46740,22080,11792,10288,19483,9027,10456,38.8,95.1,62.9,23.5,39.5,"Suffolk city, Virginia",51800,24.214508965290342,21.36645281570434,51800,150.0,1.0
149,0500000US53033,"King County, Washington",2233163,1121145,1112018,452860,230598,222262,420770,191334,229436,36.8,100.8,50.3,19.9,30.5,"King County, Washington",53033,20.278860074253423,18.841884806438223,53033,5461.0,26.0
150,0500000US54033,"Harrison County, West Virginia",67554,33013,34541,14002,7444,6558,19181,8800,10381,42.9,95.6,67.7,32.9,34.8,"Harrison County, West Virginia",54033,20.727122006098824,28.393581431151375,54033,292.0,1.0
151,0500000US06111,"Ventura County, California",850967,420907,430060,194458,98815,95643,183056,83799,99257,38.4,97.9,62.3,25.2,37.1,"Ventura County, California",06111,22.851414919732495,21.51152747403836,06111,1690.0,13.0
152,0500000US09005,"Litchfield County, Connecticut",181111,89654,91457,33007,17077,15930,54354,25908,28446,47.6,98.0,64.3,34.4,30.0,"Litchfield County, Connecticut",09005,18.224735107199454,30.011429454864697,09005,272.0,3.0
153,0500000US09007,"Middlesex County, Connecticut",162682,78396,84286,28778,14229,14549,46246,20896,25350,45.6,93.0,60.3,32.0,28.4,"Middlesex County, Connecticut",09007,17.689725968453793,28.427238416050947,09007,215.0,1.0
154,0500000US12023,"Columbia County, Florida",70503,35555,34948,15313,7153,8160,18109,8132,9977,40.7,101.7,67.0,30.7,36.3,"Columbia County, Florida",12023,21.71964313575309,25.685431825596073,12023,346.0,3.0
155,0500000US13047,"Catoosa County, Georgia",67420,33441,33979,14028,8524,5504,16359,7694,8665,41.4,98.4,63.2,29.2,33.9,"Catoosa County, Georgia",13047,20.806882230792052,24.26431326016019,13047,185.0,1.0
156,0500000US13247,"Rockdale County, Georgia",90594,42762,47832,22317,11717,10600,18996,8405,10591,38.2,89.4,63.3,23.1,40.2,"Rockdale County, Georgia",13247,24.634081727266707,20.968276044771176,13247,146.0,1.0
157,0500000US13297,"Walton County, Georgia",93503,44927,48576,23405,11746,11659,18805,8060,10745,38.2,92.5,66.9,25.1,41.8,"Walton County, Georgia",13297,25.03128241874592,20.111654171523906,13297,192.0,2.0
158,0500000US16005,"Bannock County, Idaho",87138,43519,43619,22544,11133,11411,16930,8522,8408,33.6,99.8,66.8,23.6,43.1,"Bannock County, Idaho",16005,25.871605958364892,19.428951777640066,16005,219.0,2.0
159,0500000US24003,"Anne Arundel County, Maryland",576031,285544,290487,127974,65036,62938,121105,55296,65809,38.2,98.3,58.6,23.3,35.2,"Anne Arundel County, Maryland",24003,22.216512652964855,21.02404210884484,24003,673.0,2.0
160,0500000US28033,"DeSoto County, Mississippi",182001,87944,94057,46708,24230,22478,34610,15083,19527,37.4,93.5,62.0,20.5,41.6,"DeSoto County, Mississippi",28033,25.663595254971128,19.016379030884444,28033,514.0,3.0
161,0500000US29097,"Jasper County, Missouri",120636,59060,61576,30076,15742,14334,24457,10657,13800,35.9,95.9,67.9,26.0,41.9,"Jasper County, Missouri",29097,24.931197984018038,20.273384396034352,29097,366.0,2.0
162,0500000US30029,"Flathead County, Montana",102106,51056,51050,22476,11674,10802,28598,14140,14458,41.5,100.0,71.1,33.4,37.7,"Flathead County, Montana",30029,22.01241846708323,28.0081483948054,30029,231.0,3.0
163,0500000US35001,"Bernalillo County, New Mexico",678701,333250,345451,147370,75621,71749,153101,68628,84473,37.8,96.5,61.6,26.5,35.1,"Bernalillo County, New Mexico",35001,21.7135380675732,22.55794525129623,35001,2020.0,16.0
164,0500000US36005,"Bronx County, New York",1432132,673951,758181,355049,180348,174701,258173,104335,153838,34.4,88.9,60.2,20.5,39.7,"Bronx County, New York",36005,24.79163931816341,18.027179058913564,36005,3822.0,10.0
165,0500000US37019,"Brunswick County, North Carolina",136744,65320,71424,20910,10592,10318,57841,26759,31082,54.7,91.5,89.5,60.5,29.0,"Brunswick County, North Carolina",37019,15.291347335166442,42.298748025507514,37019,160.0,2.0
166,0500000US37021,"Buncombe County, North Carolina",259103,123775,135328,47576,23828,23748,70645,31477,39168,42.5,91.5,62.2,32.4,29.8,"Buncombe County, North Carolina",37021,18.361809782210166,27.265218851190454,37021,877.0,3.0
167,0500000US37127,"Nash County, North Carolina",94016,45889,48127,20421,10984,9437,24766,10709,14057,41.8,95.3,67.4,31.1,36.4,"Nash County, North Carolina",37127,21.720770932607216,26.342324710687542,37127,403.0,2.0
168,0500000US37193,"Wilkes County, North Carolina",68557,33260,35297,14044,6915,7129,20609,9028,11581,45.4,94.2,72.2,36.9,35.3,"Wilkes County, North Carolina",37193,20.485143748997185,30.061117026707702,37193,130.0,1.0
169,0500000US39035,"Cuyahoga County, Ohio",1243857,593150,650707,257827,131262,126565,315328,137339,177989,40.4,91.2,63.7,29.8,33.9,"Cuyahoga County, Ohio",39035,20.728025810040865,25.35082408990744,39035,8368.0,26.0
170,0500000US39061,"Hamilton County, Ohio",816684,394206,422478,187275,94953,92322,176569,77747,98822,36.6,93.3,61.9,24.8,37.1,"Hamilton County, Ohio",39061,22.931145951187975,21.620234999093896,39061,5287.0,20.0
171,0500000US39165,"Warren County, Ohio",232173,117267,114906,56555,29079,27476,45673,20887,24786,39.2,102.1,63.2,23.5,39.8,"Warren County, Ohio",39165,24.358990924870678,19.67196874744264,39165,378.0,3.0
172,0500000US40017,"Canadian County, Oklahoma",144447,70792,73655,37771,18848,18923,26979,12193,14786,35.7,96.1,64.4,21.4,43.0,"Canadian County, Oklahoma",40017,26.14869121546311,18.67743878377536,40017,123.0,2.0
173,0500000US42029,"Chester County, Pennsylvania",522046,257619,264427,118708,60752,57956,120917,56323,64594,40.6,97.4,64.1,26.8,37.3,"Chester County, Pennsylvania",42029,22.738992349333202,23.162135137516618,42029,1286.0,10.0
174,0500000US42077,"Lehigh County, Pennsylvania",368100,180300,187800,83219,43030,40189,85724,38008,47716,38.5,96.0,65.4,28.0,37.4,"Lehigh County, Pennsylvania",42077,22.607715294756858,23.288236892148873,42077,1937.0,9.0
175,0500000US45063,"Lexington County, South Carolina",295032,142817,152215,68466,34504,33962,66741,29652,37089,39.0,93.8,64.1,26.0,38.1,"Lexington County, South Carolina",45063,23.20629626616774,22.62161392662491,45063,556.0,3.0
176,0500000US47119,"Maury County, Tennessee",94340,46156,48184,22116,11845,10271,20713,9617,11096,38.6,95.8,64.1,25.6,38.5,"Maury County, Tennessee",47119,23.442866228535088,21.955692177231292,47119,255.0,1.0
177,0500000US47189,"Wilson County, Tennessee",140625,69200,71425,33657,17933,15724,31831,14217,17614,40.5,96.9,66.5,26.6,39.8,"Wilson County, Tennessee",47189,23.933866666666667,22.635377777777776,47189,245.0,1.0
178,0500000US48203,"Harrison County, Texas",66726,32233,34493,16892,8337,8555,15607,7196,8411,37.9,93.4,71.3,27.9,43.4,"Harrison County, Texas",48203,25.31546923238318,23.38968318196805,48203,149.0,1.0
179,0500000US51041,"Chesterfield County, Virginia",348556,168655,179901,82720,43409,39311,74491,33994,40497,39.0,93.7,63.0,24.3,38.7,"Chesterfield County, Virginia",51041,23.732197982533656,21.371314795900805,51041,466.0,4.0
180,0500000US55131,"Washington County, Wisconsin",135693,67090,68603,29755,14707,15048,34701,16407,18294,43.3,97.8,66.3,29.9,36.5,"Washington County, Wisconsin",55131,21.928176103409903,25.573168844376642,55131,141.0,2.0
181,0500000US09003,"Hartford County, Connecticut",892697,434366,458331,187303,95536,91767,211880,92487,119393,40.3,94.8,61.5,27.6,33.9,"Hartford County, Connecticut",09003,20.98169927758243,23.734817076790893,09003,2980.0,9.0
182,0500000US12033,"Escambia County, Florida",315534,156997,158537,65783,34412,31371,74701,33346,41355,38.1,99.0,60.4,26.9,33.4,"Escambia County, Florida",12033,20.848149486267726,23.67446931234035,12033,1310.0,7.0
183,0500000US18039,"Elkhart County, Indiana",205560,101432,104128,56622,28676,27946,41493,18193,23300,35.5,97.4,72.4,24.9,47.5,"Elkhart County, Indiana",18039,27.545242265032105,20.185347343841215,18039,406.0,3.0
184,0500000US18109,"Morgan County, Indiana",70116,34971,35145,16262,8603,7659,16282,7767,8515,41.4,99.5,66.5,27.9,38.6,"Morgan County, Indiana",18109,23.192994466312967,23.221518626276456,18109,207.0,2.0
185,0500000US19049,"Dallas County, Iowa",90180,44132,46048,25588,12997,12591,13977,6126,7851,35.0,95.8,67.3,19.8,47.5,"Dallas County, Iowa",19049,28.374362386338436,15.499001996007983,19049,25.0,1.0
186,0500000US23011,"Kennebec County, Maine",122083,59257,62826,23001,11463,11538,34835,16126,18709,44.4,94.3,64.5,33.5,31.0,"Kennebec County, Maine",23011,18.840460997845728,28.53386630407182,23011,773.0,6.0
187,0500000US26049,"Genesee County, Michigan",406892,195968,210924,91553,46785,44768,100363,44800,55563,40.9,92.9,66.6,29.1,37.5,"Genesee County, Michigan",26049,22.500565260560542,24.665758972896985,26049,1169.0,4.0
188,0500000US26087,"Lapeer County, Michigan",88028,44782,43246,18300,9611,8689,23458,11171,12287,44.7,103.6,63.7,29.7,34.0,"Lapeer County, Michigan",26087,20.788839914572634,26.648339164811198,26087,183.0,1.0
189,0500000US26145,"Saginaw County, Michigan",190800,93393,97407,40848,21454,19394,49620,22599,27021,40.9,95.9,68.6,32.5,36.1,"Saginaw County, Michigan",26145,21.40880503144654,26.0062893081761,26145,968.0,6.0
190,0500000US30013,"Cascade County, Montana",81643,41630,40013,17900,9608,8292,21369,10145,11224,37.7,104.0,67.5,30.8,36.7,"Cascade County, Montana",30013,21.924721041607974,26.173707482576585,30013,436.0,3.0
191,0500000US32003,"Clark County, Nevada",2231647,1112618,1119029,517629,264050,253579,455810,214763,241047,37.6,99.4,61.1,23.7,37.4,"Clark County, Nevada",32003,23.194931814933096,20.424825252380867,32003,5467.0,33.0
192,0500000US36007,"Broome County, New York",191659,93150,98509,36745,18405,18340,50916,22735,28181,40.2,94.6,62.3,31.1,31.1,"Broome County, New York",36007,19.172071230675314,26.565932202505493,36007,742.0,3.0
193,0500000US36027,"Dutchess County, New York",293718,146156,147562,55347,28238,27109,73499,34164,39335,42.5,99.0,57.2,27.6,29.6,"Dutchess County, New York",36027,18.843584662839866,25.02366215213232,36027,676.0,3.0
194,0500000US37023,"Burke County, North Carolina",90382,45015,45367,17172,9111,8061,25163,11463,13700,44.4,99.2,63.8,32.7,31.1,"Burke County, North Carolina",37023,18.9993582793034,27.84072049744418,37023,446.0,2.0
195,0500000US37035,"Catawba County, North Carolina",158652,76611,82041,35042,17056,17986,38987,17914,21073,41.3,93.4,66.0,29.3,36.7,"Catawba County, North Carolina",37035,22.087335804149962,24.57391019337922,37035,613.0,2.0
196,0500000US37125,"Moore County, North Carolina",98682,48150,50532,20853,11170,9683,31121,14308,16813,45.5,95.3,81.9,43.5,38.4,"Moore County, North Carolina",37125,21.13151334589895,31.536653087695832,37125,372.0,1.0
197,0500000US39009,"Athens County, Ohio",65818,33319,32499,9575,5454,4121,12145,5652,6493,30.1,102.5,38.3,18.1,20.1,"Athens County, Ohio",39009,14.547692120696464,18.452399039776353,39009,245.0,3.0
198,0500000US39023,"Clark County, Ohio",134585,65014,69571,30121,15437,14684,35238,16052,19186,41.5,93.4,71.4,33.1,38.4,"Clark County, Ohio",39023,22.380651632797115,26.1827098116432,39023,294.0,3.0
199,0500000US39099,"Mahoning County, Ohio",229642,113227,116415,46144,24007,22137,67101,30516,36585,43.3,97.3,69.7,35.6,34.1,"Mahoning County, Ohio",39099,20.093885264890567,29.21982912533422,39099,1495.0,9.0
200,0500000US45051,"Horry County, South Carolina",344147,166682,177465,61592,32312,29280,111519,50639,60880,46.3,93.9,72.7,41.8,30.9,"Horry County, South Carolina",45051,17.89700331544369,32.40446669591773,45051,753.0,5.0
201,0500000US47093,"Knox County, Tennessee",465289,225264,240025,97541,49449,48092,100827,45231,55596,37.4,93.9,58.0,24.9,33.1,"Knox County, Tennessee",47093,20.96353019306281,21.66975793539069,47093,2155.0,10.0
202,0500000US51061,"Fauquier County, Virginia",70675,34514,36161,16608,8340,8268,16654,7425,9229,40.6,95.4,67.7,28.3,39.4,"Fauquier County, Virginia",51061,23.499115670321896,23.564202334630348,51061,97.0,1.0
203,0500000US01069,"Houston County, Alabama",104722,50400,54322,24121,12580,11541,25810,11362,14448,40.2,92.8,69.4,30.4,39.0,"Houston County, Alabama",01069,23.033364527033477,24.646206145795535,01069,782.0,5.0
204,0500000US06083,"Santa Barbara County, California",446527,223408,223119,99331,50580,48751,93302,43560,49742,34.0,100.1,60.2,24.5,35.6,"Santa Barbara County, California",06083,22.245239369623786,20.895041061346795,06083,1054.0,9.0
205,0500000US10003,"New Castle County, Delaware",559335,271116,288219,120253,60877,59376,123061,54609,68452,38.4,94.1,58.9,24.7,34.2,"New Castle County, Delaware",10003,21.49928039546962,22.001305121260067,10003,2016.0,9.0
206,0500000US12113,"Santa Rosa County, Florida",179349,91848,87501,39294,20764,18530,42617,19938,22679,40.0,105.0,60.7,25.5,35.2,"Santa Rosa County, Florida",12113,21.909238412257665,23.762050527184428,12113,385.0,5.0
208,0500000US20091,"Johnson County, Kansas",597555,294084,303471,145641,74870,70771,123222,55486,67736,37.8,96.9,63.5,23.7,39.9,"Johnson County, Kansas",20091,24.372819238396463,20.621030700102917,20091,1611.0,16.0
209,0500000US25017,"Middlesex County, Massachusetts",1614714,790337,824377,318633,162943,155690,344801,153590,191211,38.4,95.9,53.8,23.4,30.3,"Middlesex County, Massachusetts",25017,19.733092052214822,21.353688640836705,25017,4150.0,23.0
210,0500000US25025,"Suffolk County, Massachusetts",807252,390462,416790,133658,67700,65958,136676,59203,77473,32.9,93.7,40.0,16.8,23.2,"Suffolk County, Massachusetts",25025,16.557159350487826,16.931020300971692,25025,6162.0,22.0
211,0500000US26055,"Grand Traverse County, Michigan",92573,46141,46432,18916,10166,8750,25248,11678,13570,42.6,99.4,67.5,33.2,34.2,"Grand Traverse County, Michigan",26055,20.433603750553615,27.273611096107935,26055,377.0,1.0
212,0500000US27137,"St. Louis County, Minnesota",199754,99837,99917,38011,19417,18594,53978,25375,28603,40.9,99.9,62.2,31.3,30.9,"St. Louis County, Minnesota",27137,19.028905553831212,27.02223735194289,27137,1125.0,8.0
213,0500000US31153,"Sarpy County, Nebraska",184459,92342,92117,50553,25645,24908,31617,14897,16720,34.7,100.2,65.1,19.8,45.2,"Sarpy County, Nebraska",31153,27.40609024227606,17.140394342374186,31153,208.0,3.0
214,0500000US33011,"Hillsborough County, New Hampshire",415247,205664,209583,84981,42811,42170,94446,43075,51371,41.1,98.1,56.5,24.4,32.0,"Hillsborough County, New Hampshire",33011,20.46516892355634,22.744535180266205,33011,1164.0,9.0
215,0500000US34017,"Hudson County, New Jersey",676061,336097,339964,138221,69807,68414,116561,51798,64763,35.3,98.9,47.6,17.5,30.2,"Hudson County, New Jersey",34017,20.445048597685712,17.241195690921383,34017,1878.0,7.0
216,0500000US37025,"Cabarrus County, North Carolina",211342,103559,107783,54217,28954,25263,38515,16802,21713,37.6,96.1,63.9,21.9,42.1,"Cabarrus County, North Carolina",37025,25.653679817546916,18.224016049814992,37025,497.0,2.0
217,0500000US38015,"Burleigh County, North Dakota",95273,48205,47068,21684,11428,10256,20530,9322,11208,37.4,102.4,63.0,25.9,37.1,"Burleigh County, North Dakota",38015,22.759858511855406,21.548602437206764,38015,510.0,2.0
218,0500000US39085,"Lake County, Ohio",230514,113126,117388,46210,24014,22196,64958,29310,35648,44.2,96.4,67.1,33.6,33.5,"Lake County, Ohio",39085,20.046504767606304,28.17963334114197,39085,561.0,3.0
219,0500000US39153,"Summit County, Ohio",541918,263355,278563,113126,57449,55677,137357,61891,75466,41.0,94.5,63.6,29.4,34.1,"Summit County, Ohio",39153,20.875113947128533,25.34645462966722,39153,2819.0,11.0
220,0500000US40037,"Creek County, Oklahoma",71604,35373,36231,17062,8791,8271,16957,7859,9098,40.2,97.6,70.0,29.5,40.5,"Creek County, Oklahoma",40037,23.82827774984638,23.681637897324173,40037,95.0,3.0
221,0500000US41039,"Lane County, Oregon",379611,186890,192721,69901,36126,33775,100037,45141,54896,39.5,97.0,60.8,31.2,29.6,"Lane County, Oregon",41039,18.413849967466696,26.352502956974377,41039,531.0,4.0
222,0500000US42001,"Adams County, Pennsylvania",102811,50601,52210,21167,11032,10135,28105,13144,14961,43.8,96.9,68.5,33.8,34.7,"Adams County, Pennsylvania",42001,20.588263901722577,27.336569044168424,42001,76.0,1.0
223,0500000US42041,"Cumberland County, Pennsylvania",251423,124461,126962,50809,26300,24509,62998,27931,35067,40.7,98.0,63.4,30.4,33.0,"Cumberland County, Pennsylvania",42041,20.2085728036019,25.056577958261578,42041,658.0,5.0
224,0500000US47065,"Hamilton County, Tennessee",364286,175428,188858,75764,38859,36905,88656,39274,49382,39.7,92.9,62.0,28.3,33.7,"Hamilton County, Tennessee",47065,20.797944472200413,24.33692208868856,47065,1889.0,13.0
225,0500000US47179,"Washington County, Tennessee",128607,62989,65618,24055,12392,11663,31895,13922,17973,40.7,96.0,58.7,29.0,29.7,"Washington County, Tennessee",47179,18.704269596522742,24.80036078907058,47179,1003.0,7.0
226,0500000US49005,"Cache County, Utah",127068,63636,63432,38648,19556,19092,16445,8115,8330,25.4,100.3,65.3,15.0,50.3,"Cache County, Utah",49005,30.415210753297444,12.941889382063149,49005,150.0,2.0
227,0500000US53015,"Cowlitz County, Washington",108987,53593,55394,25393,12666,12727,29096,13701,15395,40.5,96.7,73.7,33.2,40.5,"Cowlitz County, Washington",53015,23.299109068053987,26.696761999137514,53015,202.0,1.0
228,0500000US54081,"Raleigh County, West Virginia",74254,37430,36824,15716,8191,7525,21307,9992,11315,41.8,101.6,72.5,36.0,36.5,"Raleigh County, West Virginia",54081,21.165189754087322,28.694750451154142,54081,473.0,2.0
229,0500000US01103,"Morgan County, Alabama",119089,59216,59873,27098,14815,12283,28985,12815,16170,40.7,98.9,66.5,28.6,37.9,"Morgan County, Alabama",01103,22.75441056688695,24.338939784530897,01103,476.0,4.0
230,0500000US06031,"Kings County, California",151366,83591,67775,40773,20914,19859,20951,9771,11180,32.0,123.3,59.0,16.2,42.8,"Kings County, California",06031,26.936696484018867,13.841285361309675,06031,223.0,3.0
231,0500000US06089,"Shasta County, California",180040,88679,91361,38584,19980,18604,50818,23764,27054,41.5,97.1,72.4,35.5,36.9,"Shasta County, California",06089,21.430793157076206,28.225949788935793,06089,763.0,7.0
232,0500000US12073,"Leon County, Florida",292502,138408,154094,54454,27578,26876,55739,24868,30871,31.3,89.8,46.9,19.5,27.3,"Leon County, Florida",12073,18.616624843590813,19.05593807905587,12073,1208.0,5.0
233,0500000US12103,"Pinellas County, Florida",975280,467767,507513,157685,80425,77260,321328,145587,175741,48.5,92.2,69.4,42.0,27.4,"Pinellas County, Florida",12103,16.168177343942254,32.947256172586336,12103,4229.0,18.0
235,0500000US26017,"Bay County, Michigan",103923,51291,52632,21083,10538,10545,29916,13792,16124,43.3,97.5,67.7,33.6,34.0,"Bay County, Michigan",26017,20.28713566775401,28.78669784359574,26017,389.0,3.0
236,0500000US26159,"Van Buren County, Michigan",75448,37805,37643,17288,9092,8196,19265,8983,10282,42.2,100.4,71.2,32.0,39.2,"Van Buren County, Michigan",26159,22.913794931608525,25.534142720814334,26159,84.0,2.0
237,0500000US32031,"Washoe County, Nevada",465735,234654,231081,100775,51832,48943,109326,53133,56193,38.4,101.5,61.3,26.4,34.9,"Washoe County, Nevada",32031,21.637841261661674,23.473863892556928,32031,1690.0,12.0
238,0500000US33013,"Merrimack County, New Hampshire",151132,74012,77120,28595,13807,14788,39911,17982,21929,43.4,96.0,60.6,30.2,30.4,"Merrimack County, New Hampshire",33013,18.920546277426357,26.408040653203823,33013,395.0,4.0
239,0500000US39045,"Fairfield County, Ohio",155782,77951,77831,37178,19133,18045,34397,15414,18983,39.9,100.2,65.9,26.3,39.6,"Fairfield County, Ohio",39045,23.86540165102515,22.080214658946478,39045,255.0,2.0
240,0500000US45041,"Florence County, South Carolina",138159,63556,74603,32696,16185,16511,32156,14083,18073,38.3,85.2,68.4,28.5,39.8,"Florence County, South Carolina",45041,23.665486866581258,23.274632850556245,45041,1025.0,7.0
241,0500000US48005,"Angelina County, Texas",87092,42997,44095,22101,11958,10143,19192,9396,9796,38.9,97.5,70.5,27.2,43.3,"Angelina County, Texas",48005,25.376613236577413,22.03646718412713,48005,470.0,4.0
242,0500000US53057,"Skagit County, Washington",128206,63062,65144,27977,14029,13948,35896,17008,18888,41.4,96.8,74.2,36.2,38.0,"Skagit County, Washington",53057,21.821911611001045,27.99868960891066,53057,205.0,3.0
243,0500000US53067,"Thurston County, Washington",286419,139657,146762,61381,31231,30150,68690,30789,37901,38.8,95.2,62.9,28.0,34.9,"Thurston County, Washington",53067,21.430491692241088,23.9823475397931,53067,474.0,2.0
244,0500000US54039,"Kanawha County, West Virginia",180454,87033,93421,35252,18421,16831,50946,22661,28285,44.0,93.2,67.8,35.0,32.8,"Kanawha County, West Virginia",54039,19.53517239850599,28.232125638666915,54039,763.0,5.0
245,0500000US55025,"Dane County, Wisconsin",542364,268975,273389,110871,56083,54788,104990,47932,57058,35.3,98.4,52.1,21.0,31.1,"Dane County, Wisconsin",55025,20.442175365621612,19.357848234764845,55025,2073.0,8.0
246,0500000US01097,"Mobile County, Alabama",413757,197009,216748,96777,49296,47481,92616,40934,51682,38.1,90.9,65.2,26.6,38.6,"Mobile County, Alabama",01097,23.389815761425183,22.384153017350762,01097,1929.0,7.0
247,0500000US06013,"Contra Costa County, California",1150215,562983,587232,259788,133128,126660,253902,114568,139334,40.0,95.9,62.2,25.6,36.6,"Contra Costa County, California",06013,22.586038262411808,22.07430784679386,06013,1993.0,11.0
248,0500000US12083,"Marion County, Florida",359977,171353,188624,65788,32524,33264,129048,59627,69421,49.1,90.8,89.3,54.7,34.6,"Marion County, Florida",12083,18.275612052992273,35.84895701669829,12083,919.0,7.0
249,0500000US12091,"Okaloosa County, Florida",207269,104314,102955,46397,23239,23158,46296,20969,25327,36.8,101.3,63.5,26.9,36.6,"Okaloosa County, Florida",12091,22.38492007970319,22.336191133261607,12091,673.0,5.0
250,0500000US12117,"Seminole County, Florida",467832,225955,241877,98391,49907,48484,103082,46361,56721,39.2,93.4,57.7,24.5,33.2,"Seminole County, Florida",12117,21.031267634535475,22.033978009199885,12117,965.0,5.0
252,0500000US13095,"Dougherty County, Georgia",91243,42037,49206,21221,11059,10162,19136,8416,10720,35.0,85.4,62.6,24.8,37.8,"Dougherty County, Georgia",13095,23.257674561336213,20.972567758622578,13095,939.0,2.0
253,0500000US13151,"Henry County, Georgia",230220,109288,120932,58951,30024,28927,39004,16766,22238,37.6,90.4,58.8,18.1,40.7,"Henry County, Georgia",13151,25.606376509425765,16.942055425245417,13151,265.0,2.0
254,0500000US13153,"Houston County, Georgia",155469,77540,77929,38789,20299,18490,27113,10745,16368,36.1,99.5,58.1,18.7,39.5,"Houston County, Georgia",13153,24.949668422643743,17.439489544539427,13153,276.0,2.0
255,0500000US17183,"Vermilion County, Illinois",76806,38315,38491,18046,9063,8983,19695,9344,10351,40.4,99.5,76.1,34.8,41.4,"Vermilion County, Illinois",17183,23.495560242689372,25.642527927505665,17183,447.0,3.0
256,0500000US17197,"Will County, Illinois",692310,343985,348325,171783,87793,83990,132395,62288,70107,38.1,98.8,61.0,21.0,39.9,"Will County, Illinois",17197,24.813017289942366,19.123658476693965,17197,917.0,3.0
257,0500000US18141,"St. Joseph County, Indiana",270771,131804,138967,64262,32612,31650,61059,27291,33768,37.0,94.8,65.8,26.4,39.3,"St. Joseph County, Indiana",18141,23.732969926616956,22.55005151954973,18141,811.0,6.0
258,0500000US19163,"Scott County, Iowa",173283,85093,88190,41322,21114,20208,39142,17789,21353,38.3,96.5,66.0,26.4,39.6,"Scott County, Iowa",19163,23.846540052976923,22.588482424704097,19163,1193.0,4.0
259,0500000US23019,"Penobscot County, Maine",151096,75100,75996,26744,13763,12981,39016,18765,20251,42.2,98.8,56.4,28.7,27.7,"Penobscot County, Maine",23019,17.700005294647113,25.82199396410229,23019,773.0,6.0
260,0500000US26111,"Midland County, Michigan",83209,40637,42572,18229,9104,9125,21712,9602,12110,41.8,95.5,68.3,31.4,36.9,"Midland County, Michigan",26111,21.907485969065846,26.093331250225337,26111,308.0,1.0
261,0500000US26115,"Monroe County, Michigan",150439,74423,76016,32182,16444,15738,37931,17071,20860,42.5,97.9,65.8,30.4,35.5,"Monroe County, Michigan",26115,21.39205923995772,25.213541701287568,26115,217.0,1.0
262,0500000US27145,"Stearns County, Minnesota",159256,80139,79117,36702,18753,17949,33166,15870,17296,34.9,101.3,61.6,24.3,37.2,"Stearns County, Minnesota",27145,23.045913497764605,20.82558898879791,27145,588.0,5.0
264,0500000US36101,"Steuben County, New York",95796,48423,47373,20389,10604,9785,25936,12422,13514,42.9,102.2,68.8,32.9,35.9,"Steuben County, New York",36101,21.283769677230783,27.07419934026473,36101,214.0,4.0
265,0500000US37097,"Iredell County, North Carolina",178435,87384,91051,41060,20452,20608,38571,17667,20904,40.0,96.0,62.9,25.4,37.5,"Iredell County, North Carolina",37097,23.01118054193404,21.616274833973158,37097,501.0,3.0
266,0500000US38017,"Cass County, North Dakota",181516,93155,88361,40853,21744,19109,32467,14596,17871,32.4,105.4,52.5,18.1,34.3,"Cass County, North Dakota",38017,22.506555895898984,17.886577491791357,38017,1262.0,6.0
267,0500000US38101,"Ward County, North Dakota",67744,36023,31721,15949,8526,7423,11673,5556,6117,31.4,113.6,56.3,19.5,36.8,"Ward County, North Dakota",38101,23.543044402456307,17.23104629192253,38101,527.0,3.0
268,0500000US41051,"Multnomah County, Oregon",811880,402662,409218,152900,78846,74054,151776,69823,81953,37.6,98.4,47.6,19.8,27.8,"Multnomah County, Oregon",41051,18.832832438291373,18.69438833325122,41051,1978.0,7.0
269,0500000US42021,"Cambria County, Pennsylvania",131730,65065,66665,25226,12802,12424,40498,18453,22045,45.9,97.6,71.4,38.6,32.8,"Cambria County, Pennsylvania",42021,19.149776057086466,30.743186821528884,42021,594.0,4.0
270,0500000US48485,"Wichita County, Texas",132064,67373,64691,29552,14277,15275,26659,12257,14402,34.5,104.1,58.4,23.0,35.5,"Wichita County, Texas",48485,22.377029319118,20.18642476375091,48485,559.0,6.0
271,0500000US51015,"Augusta County, Virginia",75457,38441,37016,14362,7249,7113,22335,10932,11403,45.3,103.8,67.7,35.8,31.9,"Augusta County, Virginia",51015,19.033356746226325,29.599639529798427,51015,255.0,1.0
272,0500000US51550,"Chesapeake city, Virginia",242634,118384,124250,58199,29036,29163,46358,20700,25658,37.1,95.3,59.2,21.0,38.2,"Chesapeake city, Virginia",51550,23.986333325090463,19.106143409415,51550,310.0,1.0
273,0500000US51770,"Roanoke city, Virginia",99920,47479,52441,22229,11792,10437,23748,9252,14496,38.1,90.5,64.4,27.8,36.6,"Roanoke city, Virginia",51770,22.24679743795036,23.76701361088871,51770,934.0,2.0
274,0500000US54011,"Cabell County, West Virginia",93224,44918,48306,18444,9385,9059,22698,10094,12604,38.3,93.0,61.3,29.4,31.9,"Cabell County, West Virginia",54011,19.784604822792414,24.34780743156269,54011,1051.0,6.0
275,0500000US55141,"Wood County, Wisconsin",73055,36342,36713,15666,7802,7864,20220,9261,10959,43.9,99.0,72.1,35.2,36.9,"Wood County, Wisconsin",55141,21.444117445760043,27.67777701731572,55141,619.0,3.0
276,0500000US01083,"Limestone County, Alabama",96174,49198,46976,22441,12403,10038,20633,9234,11399,38.8,104.7,64.0,25.7,38.3,"Limestone County, Alabama",01083,23.333749246158007,21.453823278640797,01083,102.0,2.0
277,0500000US05051,"Garland County, Arkansas",99154,47098,52056,19787,9513,10274,31751,14567,17184,44.6,90.5,75.9,40.8,35.1,"Garland County, Arkansas",05051,19.95582629041693,32.021905318998726,05051,646.0,6.0
278,0500000US08069,"Larimer County, Colorado",350518,174084,176434,68998,34824,34174,77279,36110,41169,36.4,98.7,54.7,24.3,30.5,"Larimer County, Colorado",08069,19.684581105677882,22.04708460050554,08069,725.0,8.0
279,0500000US12035,"Flagler County, Florida",112067,53523,58544,19130,9349,9781,43227,20553,22674,51.8,91.4,94.6,61.4,33.2,"Flagler County, Florida",12035,17.070145537937126,38.57246111701036,12035,99.0,1.0
280,0500000US17201,"Winnebago County, Illinois",284081,138909,145172,66289,33973,32316,70425,32785,37640,39.5,95.7,68.9,29.5,39.4,"Winnebago County, Illinois",17201,23.33454190882178,24.790464691408438,17201,907.0,4.0
281,0500000US24025,"Harford County, Maryland",253956,124169,129787,56172,29010,27162,60001,26772,33229,40.9,95.7,63.0,27.0,36.1,"Harford County, Maryland",24025,22.11879223172518,23.626533730252486,24025,255.0,2.0
282,0500000US30031,"Gallatin County, Montana",111876,57812,54064,22863,11820,11043,21230,10263,10967,33.8,106.9,50.0,19.3,30.7,"Gallatin County, Montana",30031,20.436018448997103,18.976366691694377,30031,90.0,2.0
283,0500000US37157,"Rockingham County, North Carolina",90690,43957,46733,18386,9986,8400,26012,11607,14405,44.3,94.1,69.0,34.7,34.3,"Rockingham County, North Carolina",37157,20.273459036277426,28.68232440180836,37157,352.0,2.0
284,0500000US39155,"Trumbull County, Ohio",198627,96599,102028,40677,20828,19849,57963,25991,31972,44.6,94.7,73.0,37.6,35.4,"Trumbull County, Ohio",39155,20.479088945611622,29.181833285504993,39155,693.0,5.0
285,0500000US42019,"Butler County, Pennsylvania",187888,93038,94850,37515,19368,18147,51254,24348,26906,43.7,98.1,62.8,30.3,32.5,"Butler County, Pennsylvania",42019,19.96668227880439,27.27901728689432,42019,296.0,1.0
286,0500000US42049,"Erie County, Pennsylvania",272061,133664,138397,58107,29078,29029,67077,30496,36581,40.0,96.6,64.9,29.6,35.2,"Erie County, Pennsylvania",42049,21.358077784026378,24.65513248866982,42049,1223.0,9.0
287,0500000US42079,"Luzerne County, Pennsylvania",317646,156745,160901,62768,31610,31158,86259,39059,47200,43.2,97.4,65.9,33.1,32.8,"Luzerne County, Pennsylvania",42079,19.76036216417018,27.155701630116546,42079,1247.0,8.0
288,0500000US45055,"Kershaw County, South Carolina",65592,32806,32786,15115,8735,6380,16382,7813,8569,41.8,100.1,70.2,30.9,39.2,"Kershaw County, South Carolina",45055,23.04396877668008,24.975606781314795,45055,121.0,1.0
289,0500000US51107,"Loudoun County, Virginia",406850,201651,205199,114958,58570,56388,56737,25168,31569,36.4,98.3,60.1,14.8,45.2,"Loudoun County, Virginia",51107,28.255622465282045,13.945434435295564,51107,462.0,4.0
290,0500000US01073,"Jefferson County, Alabama",659300,312159,347141,149547,76381,73166,150188,63722,86466,38.2,89.9,62.8,25.8,36.9,"Jefferson County, Alabama",01073,22.682693766115577,22.77991809494919,01073,4926.0,13.0
291,0500000US04013,"Maricopa County, Arizona",4410824,2181974,2228850,1052785,537712,515073,918193,419848,498345,36.6,97.9,64.0,24.9,39.2,"Maricopa County, Arizona",04013,23.868216006805078,20.816813366391404,04013,9767.0,56.0
292,0500000US05069,"Jefferson County, Arkansas",68114,33440,34674,14884,7209,7675,16976,7723,9253,40.1,96.4,63.9,28.1,35.8,"Jefferson County, Arkansas",05069,21.85160172651731,24.922923334409962,05069,498.0,2.0
293,0500000US05145,"White County, Arkansas",78727,38110,40617,18295,9817,8478,16644,7140,9504,36.9,93.8,63.6,25.6,38.0,"White County, Arkansas",05145,23.23853315889085,21.141412730067195,05145,506.0,3.0
294,0500000US06079,"San Luis Obispo County, California",284010,143754,140256,49675,25467,24208,77677,36813,40864,39.6,102.5,60.7,32.6,28.1,"San Luis Obispo County, California",06079,17.49058131755924,27.350093306573715,06079,1747.0,6.0
295,0500000US08014,"Broomfield County, Colorado",69267,34710,34557,15867,8028,7839,12749,5690,7059,37.5,100.4,58.2,22.0,36.2,"Broomfield County, Colorado",08014,22.907011997054873,18.405589963474668,08014,92.0,1.0
296,0500000US09009,"New Haven County, Connecticut",857620,412943,444677,173312,88522,84790,209557,91426,118131,40.5,92.9,60.1,27.8,32.4,"New Haven County, Connecticut",09009,20.208483943937875,24.434714675497307,09009,3045.0,8.0
297,0500000US12061,"Indian River County, Florida",157413,76541,80872,25217,14327,10890,67498,30121,37377,54.5,94.6,94.8,63.6,31.2,"Indian River County, Florida",12061,16.019642596227758,42.879558867437886,12061,612.0,4.0
298,0500000US13021,"Bibb County, Georgia",153095,72997,80098,37623,20014,17609,34017,14589,19428,36.3,91.1,67.3,26.2,41.1,"Bibb County, Georgia",13021,24.574937130539862,22.21953688885986,13021,1294.0,8.0
299,0500000US13089,"DeKalb County, Georgia",756558,356943,399615,175679,88535,87144,137985,57075,80910,35.9,89.3,55.4,19.3,36.1,"DeKalb County, Georgia",13089,23.22082378350371,18.238522360479966,13089,2604.0,14.0
300,0500000US13127,"Glynn County, Georgia",85219,38778,46441,18678,8522,10156,22790,10144,12646,40.3,83.5,71.9,34.2,37.7,"Glynn County, Georgia",13127,21.91764747298138,26.742862507187365,13127,401.0,2.0
301,0500000US16001,"Ada County, Idaho",469966,235896,234070,111023,57949,53074,93661,44237,49424,37.4,100.8,61.2,23.2,38.1,"Ada County, Idaho",16001,23.62362383661797,19.92931403548342,16001,1354.0,8.0
302,0500000US17111,"McHenry County, Illinois",308570,153957,154613,72282,37560,34722,65093,30172,34921,40.9,99.6,61.0,23.3,37.7,"McHenry County, Illinois",17111,23.424830670512364,21.095051365978545,17111,343.0,3.0
303,0500000US17179,"Tazewell County, Illinois",132328,65006,67322,29733,15147,14586,34926,15848,19078,41.0,96.6,71.1,32.7,38.4,"Tazewell County, Illinois",17179,22.46916752312436,26.393507043105014,17179,150.0,2.0
304,0500000US18053,"Grant County, Indiana",65936,31214,34722,13607,6591,7016,17037,7533,9504,41.4,89.9,65.7,31.5,34.2,"Grant County, Indiana",18053,20.63667799077894,25.83869206503276,18053,113.0,2.0
305,0500000US18081,"Johnson County, Indiana",156225,76121,80104,39191,20017,19174,31561,13613,17948,37.1,95.0,65.6,24.1,41.6,"Johnson County, Indiana",18081,25.086253800608098,20.20227236357817,18081,275.0,3.0
306,0500000US19103,"Johnson County, Iowa",151260,75678,75582,30182,16449,13733,25643,11202,14441,30.3,100.1,46.1,17.0,29.2,"Johnson County, Iowa",19103,19.95372206796245,16.952928731984663,19103,1383.0,3.0
307,0500000US26099,"Macomb County, Michigan",874759,425723,449036,184009,93978,90031,210417,95004,115413,40.7,94.8,61.5,27.5,34.0,"Macomb County, Michigan",26099,21.035393748449575,24.054282379489667,26099,1322.0,6.0
308,0500000US27131,"Rice County, Minnesota",66523,34196,32327,14884,7971,6913,14345,6494,7851,36.2,105.8,60.9,24.9,36.0,"Rice County, Minnesota",27131,22.374216436420486,21.56397035611743,27131,49.0,1.0
309,0500000US29051,"Cole County, Missouri",76796,38570,38226,17241,8564,8677,17637,8022,9615,39.1,100.9,64.9,27.9,37.0,"Cole County, Missouri",29051,22.450388041043805,22.96603989791135,29051,402.0,3.0
310,0500000US29071,"Franklin County, Missouri",103670,52247,51423,23753,12357,11396,25266,11378,13888,40.4,101.6,67.3,29.0,38.3,"Franklin County, Missouri",29071,22.91212501205749,24.371563615317836,29071,148.0,1.0
311,0500000US33017,"Strafford County, New Hampshire",130090,63074,67016,24199,12064,12135,27721,12946,14775,37.3,94.1,50.0,22.1,27.9,"Strafford County, New Hampshire",33017,18.601737258820815,21.30909370435852,33017,290.0,2.0
312,0500000US36067,"Onondaga County, New York",461809,222736,239073,98023,49715,48308,111857,50184,61673,39.3,93.2,62.1,27.7,34.4,"Onondaga County, New York",36067,21.225874766407756,24.221485505912618,36067,1672.0,5.0
313,0500000US36069,"Ontario County, New York",109864,53729,56135,22309,11594,10715,30168,13801,16367,43.7,95.7,66.7,32.8,33.8,"Ontario County, New York",36069,20.30601470909488,27.459404354474625,36069,399.0,3.0
314,0500000US37069,"Franklin County, North Carolina",67560,32424,35136,14621,6659,7962,16089,7306,8783,40.6,92.3,63.6,28.2,35.4,"Franklin County, North Carolina",37069,21.641503848431025,23.814387211367674,37069,83.0,1.0
315,0500000US37161,"Rutherford County, North Carolina",66826,31983,34843,13782,7024,6758,20307,9572,10735,45.0,91.8,71.4,36.1,35.4,"Rutherford County, North Carolina",37161,20.62370933469009,30.38787298356927,37161,143.0,1.0
316,0500000US39169,"Wayne County, Ohio",115967,57444,58523,28092,14359,13733,28609,13690,14919,38.9,98.2,71.5,30.0,41.5,"Wayne County, Ohio",39169,24.22413272741383,24.669949209688962,39169,184.0,2.0
317,0500000US41019,"Douglas County, Oregon",110283,54333,55950,21351,10747,10604,36923,17437,19486,47.0,97.1,80.8,45.8,35.0,"Douglas County, Oregon",41019,19.360191507303938,33.48022814032988,41019,141.0,2.0
318,0500000US42055,"Franklin County, Pennsylvania",154835,75735,79100,34503,17835,16668,40372,18567,21805,40.7,95.7,71.3,33.1,38.2,"Franklin County, Pennsylvania",42055,22.28372138082475,26.07420802790067,42055,416.0,3.0
319,0500000US42133,"York County, Pennsylvania",448273,221982,226291,98940,51104,47836,110523,50956,59567,40.9,98.1,65.3,28.8,36.5,"York County, Pennsylvania",42133,22.071371686449996,24.65528818376302,42133,921.0,6.0
320,0500000US44007,"Providence County, Rhode Island",636084,309606,326478,129957,66360,63597,139266,61193,78073,37.4,94.8,55.6,23.8,31.8,"Providence County, Rhode Island",44007,20.4307921595261,21.89427811421133,44007,3272.0,13.0
321,0500000US45013,"Beaufort County, South Carolina",188715,91097,97618,35251,16894,18357,63679,29674,34005,45.5,93.3,85.1,50.6,34.6,"Beaufort County, South Carolina",45013,18.679490236600163,33.74347561137164,45013,290.0,2.0
322,0500000US47125,"Montgomery County, Tennessee",205950,102794,103156,54940,28296,26644,28140,12721,15419,30.9,99.6,55.5,14.0,41.5,"Montgomery County, Tennessee",47125,26.67637776159262,13.66351056081573,47125,270.0,1.0
323,0500000US47165,"Sumner County, Tennessee",187149,92547,94602,43916,23631,20285,41123,18423,22700,40.2,97.8,64.4,25.8,38.6,"Sumner County, Tennessee",47165,23.465794634221933,21.973400873101113,47165,441.0,3.0
324,0500000US48251,"Johnson County, Texas",171361,85556,85805,44421,22560,21861,32466,14970,17496,37.0,99.7,65.9,22.9,43.0,"Johnson County, Texas",48251,25.92246777271374,18.9459678690017,48251,137.0,1.0
325,0500000US48309,"McLennan County, Texas",254607,124231,130376,63033,32400,30633,50911,22916,27995,32.9,95.3,64.3,23.6,40.7,"McLennan County, Texas",48309,24.7569784020078,19.99591527334284,48309,861.0,3.0
326,0500000US48397,"Rockwall County, Texas",100657,48922,51735,27170,13847,13323,17129,7789,9340,38.3,94.6,64.5,20.1,44.4,"Rockwall County, Texas",48397,26.992658235393463,17.01719701560746,48397,170.0,3.0
327,0500000US48409,"San Patricio County, Texas",66893,34023,32870,17745,9380,8365,13785,6774,7011,36.7,103.5,71.0,25.7,45.4,"San Patricio County, Texas",48409,26.52743934342906,20.607537410491382,48409,75.0,1.0
328,0500000US49049,"Utah County, Utah",622213,314444,307769,207710,106817,100893,68027,31823,36204,24.9,102.2,69.8,13.1,56.7,"Utah County, Utah",49049,33.3824590614468,10.933072758042664,49049,1033.0,6.0
329,0500000US51179,"Stafford County, Virginia",149960,75079,74881,39247,19502,19745,22866,10938,11928,35.8,100.3,57.3,16.2,41.2,"Stafford County, Virginia",51179,26.17164577220592,15.248066150973594,51179,100.0,1.0
330,0500000US51510,"Alexandria city, Virginia",160530,77087,83443,29435,15035,14400,27776,12539,15237,36.5,92.4,44.0,17.6,26.4,"Alexandria city, Virginia",51510,18.33613654768579,17.30268485641313,51510,318.0,1.0
331,0500000US53077,"Yakima County, Washington",251446,125234,126212,74450,37897,36553,47905,22348,25557,33.3,99.2,76.2,24.1,52.2,"Yakima County, Washington",53077,29.608743030312674,19.05180436356116,53077,528.0,4.0
332,0500000US01089,"Madison County, Alabama",366519,178964,187555,80048,40875,39173,76390,34238,42152,38.5,95.4,58.8,24.1,34.7,"Madison County, Alabama",01089,21.840068318422784,20.84203001754343,01089,1178.0,5.0
333,0500000US06087,"Santa Cruz County, California",274255,134866,139389,52617,26881,25736,63875,29885,33990,37.9,96.8,55.6,25.7,29.8,"Santa Cruz County, California",06087,19.185429618420812,23.29036845271736,06087,432.0,5.0
334,0500000US12085,"Martin County, Florida",160912,79107,81805,26502,13406,13096,62829,28852,33977,52.5,96.7,91.6,60.0,31.6,"Martin County, Florida",12085,16.469871731132542,39.04556527791588,12085,558.0,5.0
335,0500000US15003,"Honolulu County, Hawaii",980080,492913,487167,207907,106908,100999,233253,105429,127824,38.1,101.2,63.7,29.0,34.7,"Honolulu County, Hawaii",15003,21.213268304628194,23.79938372377765,15003,2459.0,16.0
336,0500000US16055,"Kootenai County, Idaho",161505,79091,82414,36630,18001,18629,40751,19630,21121,40.6,96.0,71.2,32.4,38.8,"Kootenai County, Idaho",16055,22.68041237113402,25.232036159871214,16055,396.0,4.0
337,0500000US17113,"McLean County, Illinois",172828,84289,88539,37134,19296,17838,32371,14305,18066,33.4,95.2,53.0,20.1,32.9,"McLean County, Illinois",17113,21.486101789061955,18.73018260929942,17113,200.0,1.0
338,0500000US17161,"Rock Island County, Illinois",143477,69273,74204,31980,15888,16092,36152,15981,20171,40.4,93.4,69.6,31.8,37.8,"Rock Island County, Illinois",17161,22.28928678464144,25.197069913644693,17161,444.0,2.0
339,0500000US18157,"Tippecanoe County, Indiana",193048,98987,94061,40134,21158,18976,31377,14089,17288,28.2,105.2,47.9,17.2,30.7,"Tippecanoe County, Indiana",18157,20.789648170403215,16.253470639426464,18157,813.0,7.0
340,0500000US18177,"Wayne County, Indiana",65936,31452,34484,14475,7452,7023,17048,7557,9491,40.3,91.2,69.0,31.9,37.1,"Wayne County, Indiana",18177,21.95310604222276,25.85537490900267,18177,251.0,2.0
341,0500000US19193,"Woodbury County, Iowa",102539,51134,51405,26651,13900,12751,22617,9624,12993,36.7,99.5,70.6,26.3,44.4,"Woodbury County, Iowa",19193,25.99108631837642,22.05697344425048,19193,830.0,2.0
342,0500000US21145,"McCracken County, Kentucky",65346,30816,34530,14253,7062,7191,18167,7224,10943,42.8,89.2,73.3,35.5,37.8,"McCracken County, Kentucky",21145,21.811587549352677,27.801242616227466,21145,708.0,2.0
343,0500000US22073,"Ouachita Parish, Louisiana",154475,74556,79919,39163,20188,18975,33445,14956,18489,35.5,93.3,67.1,24.7,42.4,"Ouachita Parish, Louisiana",22073,25.352322382262503,21.65075254895614,22073,679.0,6.0
344,0500000US23001,"Androscoggin County, Maine",107679,53089,54590,22257,11681,10576,26687,11652,15035,41.9,97.3,62.8,29.2,33.7,"Androscoggin County, Maine",23001,20.669768478533417,24.783848289824387,23001,483.0,2.0
345,0500000US27037,"Dakota County, Minnesota",425423,208780,216643,103633,53012,50621,84706,37830,46876,38.2,96.4,62.0,22.6,39.5,"Dakota County, Minnesota",27037,24.359989939424995,19.91100622204253,27037,259.0,3.0
346,0500000US27123,"Ramsey County, Minnesota",550210,268736,281474,128233,65779,62454,112223,48948,63275,35.1,95.5,60.6,23.2,37.4,"Ramsey County, Minnesota",27123,23.30619218116719,20.396394104069355,27123,1907.0,6.0
347,0500000US36015,"Chemung County, New York",84254,40747,43507,17598,9210,8388,22180,9342,12838,43.1,93.7,68.4,33.2,35.2,"Chemung County, New York",36015,20.886842167730908,26.32515963633774,36015,391.0,2.0
348,0500000US42097,"Northumberland County, Pennsylvania",91083,46104,44979,17800,8936,8864,26535,12065,14470,44.6,102.5,69.8,36.6,33.2,"Northumberland County, Pennsylvania",42097,19.542614977547952,29.132769012878363,42097,173.0,2.0
349,0500000US46103,"Pennington County, South Dakota",111729,56411,55318,25304,13522,11782,29425,13577,15848,40.1,102.0,69.4,31.0,38.4,"Pennington County, South Dakota",46103,22.647656382854944,26.33604525235167,46103,509.0,5.0
350,0500000US48037,"Bowie County, Texas",94324,47223,47101,22688,11255,11433,21570,9872,11698,37.5,100.3,67.5,27.2,40.3,"Bowie County, Texas",48037,24.053263220389294,22.86798693863704,48037,841.0,6.0
351,0500000US48141,"El Paso County, Texas",840758,414919,425839,228101,116242,111859,146106,63056,83050,32.5,97.4,65.0,20.2,44.8,"El Paso County, Texas",48141,27.13039899709548,17.377889951686456,48141,2466.0,16.0
352,0500000US49053,"Washington County, Utah",171700,84845,86855,44725,23505,21220,46419,22049,24370,38.2,97.7,91.5,41.6,49.9,"Washington County, Utah",49053,26.04834012813046,27.034944670937683,49053,261.0,1.0
353,0500000US51003,"Albemarle County, Virginia",108718,51711,57007,21527,10879,10648,28230,12515,15715,38.6,90.7,64.2,31.7,32.5,"Albemarle County, Virginia",51003,19.800768961901433,25.966261336669184,51003,285.0,4.0
354,0500000US51680,"Lynchburg city, Virginia",82126,38123,44003,16004,7535,8469,16795,6895,9900,28.4,86.6,51.5,22.0,29.5,"Lynchburg city, Virginia",51680,19.48712953266931,20.45028371039622,51680,738.0,3.0
355,0500000US53063,"Spokane County, Washington",514631,253650,260981,114053,57465,56588,113934,52003,61931,37.8,97.2,62.3,26.3,36.0,"Spokane County, Washington",53063,22.16209283933537,22.13896947521622,53063,1881.0,10.0
356,0500000US55097,"Portage County, Wisconsin",70942,35628,35314,13929,7256,6673,16085,7581,8504,37.1,100.9,56.4,25.7,30.7,"Portage County, Wisconsin",55097,19.634349186659524,22.673451551972036,55097,94.0,1.0
357,0500000US01043,"Cullman County, Alabama",83442,40794,42648,18892,9304,9588,21664,10125,11539,40.6,95.7,70.3,31.7,38.5,"Cullman County, Alabama",01043,22.64087629730831,25.962944320605928,01043,185.0,2.0
358,0500000US06037,"Los Angeles County, California",10105518,4982529,5122989,2188893,1120903,1067990,1949791,873538,1076253,36.7,97.3,54.5,21.0,33.5,"Los Angeles County, California",06037,21.66037406494155,19.294320192195986,06037,30371.0,127.0
359,0500000US06061,"Placer County, California",393149,193296,199853,87122,45539,41583,103122,46395,56727,42.3,96.7,71.5,33.5,38.0,"Placer County, California",06061,22.16004619113873,26.229750043876493,06061,748.0,4.0
360,0500000US09013,"Tolland County, Connecticut",150921,75123,75798,26203,13070,13133,34279,16533,17746,36.7,99.1,50.3,24.2,26.1,"Tolland County, Connecticut",09013,17.362063596186083,22.713207572173523,09013,174.0,2.0
361,0500000US10005,"Sussex County, Delaware",229286,111003,118283,42252,21277,20975,84619,39415,45204,50.6,93.8,86.1,51.8,34.3,"Sussex County, Delaware",10005,18.427640588609858,36.90543687796028,10005,476.0,3.0
362,0500000US13031,"Bulloch County, Georgia",77296,38232,39064,14940,7620,7320,12960,6232,6728,28.1,97.9,43.6,15.9,27.8,"Bulloch County, Georgia",13031,19.32829641896088,16.76671496584558,13031,190.0,2.0
363,0500000US13115,"Floyd County, Georgia",97927,46055,51872,22625,10992,11633,22880,10086,12794,38.4,88.8,66.6,28.1,38.5,"Floyd County, Georgia",13115,23.10394477518968,23.364342826799557,13115,910.0,5.0
364,0500000US13217,"Newton County, Georgia",109541,52294,57247,28413,15157,13256,20765,9030,11735,36.8,91.3,64.1,21.5,42.6,"Newton County, Georgia",13217,25.9382331729672,18.956372499794597,13217,97.0,1.0
365,0500000US17031,"Cook County, Illinois",5180493,2516466,2664027,1129672,575213,554459,1071308,467015,604293,37.0,94.5,57.3,23.0,34.3,"Cook County, Illinois",17031,21.80626438449005,20.679653461552792,17031,18259.0,66.0
366,0500000US21047,"Christian County, Kentucky",71671,37000,34671,19005,8970,10035,12553,5597,6956,28.2,106.7,63.6,20.3,43.4,"Christian County, Kentucky",21047,26.51700129759596,17.514754921795426,21047,786.0,3.0
367,0500000US25011,"Franklin County, Massachusetts",70963,34401,36562,12746,6371,6375,22771,10402,12369,46.7,94.1,65.8,36.0,29.8,"Franklin County, Massachusetts",25011,17.961472880233362,32.0885531896904,25011,89.0,1.0
368,0500000US25013,"Hampden County, Massachusetts",470406,227450,242956,101138,52059,49079,109583,48015,61568,39.1,93.6,61.9,27.1,34.8,"Hampden County, Massachusetts",25013,21.500150933448978,23.29540864699855,25013,1773.0,10.0
369,0500000US26155,"Shiawassee County, Michigan",68192,33604,34588,14566,7523,7043,17634,8605,9029,42.7,97.2,66.2,30.7,35.5,"Shiawassee County, Michigan",26155,21.360276865321445,25.85933833880807,26155,107.0,1.0
370,0500000US29047,"Clay County, Missouri",246365,120169,126196,59577,30363,29214,49877,22592,27285,37.3,95.2,62.1,22.9,39.2,"Clay County, Missouri",29047,24.182412274470806,20.24516469466036,29047,905.0,6.0
371,0500000US30063,"Missoula County, Montana",118791,59085,59706,22121,11481,10640,25583,12021,13562,36.3,99.0,51.5,23.3,28.2,"Missoula County, Montana",30063,18.621781111363656,21.536143310520156,30063,404.0,2.0
372,0500000US30111,"Yellowstone County, Montana",160137,78902,81235,37615,18981,18634,38150,17065,21085,37.9,97.1,67.9,28.5,39.4,"Yellowstone County, Montana",30111,23.489262319139236,23.823351255487488,30111,630.0,3.0
373,0500000US36045,"Jefferson County, New York",111755,58729,53026,26799,13667,13132,21841,9850,11991,33.0,110.8,60.8,22.2,38.6,"Jefferson County, New York",36045,23.980135116997005,19.543644579660864,36045,344.0,3.0
374,0500000US39063,"Hancock County, Ohio",75930,37308,38622,16770,8198,8572,17527,7524,10003,39.6,96.6,63.9,27.7,36.2,"Hancock County, Ohio",39063,22.086131963650733,23.08310285789543,39063,176.0,1.0
375,0500000US39151,"Stark County, Ohio",371574,180157,191417,79683,40625,39058,97680,43178,54502,42.0,94.1,69.0,32.8,36.2,"Stark County, Ohio",39151,21.44471895234866,26.288168709328424,39151,1740.0,7.0
376,0500000US42005,"Armstrong County, Pennsylvania",65263,32871,32392,12342,6432,5910,19628,9240,10388,46.6,101.5,68.9,36.9,31.9,"Armstrong County, Pennsylvania",42005,18.911174785100286,30.07523405298561,42005,155.0,1.0
377,0500000US48139,"Ellis County, Texas",179436,88519,90917,47748,24611,23137,31712,14599,17113,36.5,97.4,64.7,20.9,43.8,"Ellis County, Texas",48139,26.610044807062128,17.673153659243408,48139,233.0,3.0
378,0500000US48201,"Harris County, Texas",4698619,2334547,2364072,1251684,637891,613793,740322,337256,403066,33.7,98.8,59.1,16.7,42.4,"Harris County, Texas",48201,26.639401917882683,15.75616154448786,48201,15996.0,89.0
379,0500000US48291,"Liberty County, Texas",86323,43214,43109,22869,12521,10348,16185,7232,8953,35.3,100.2,64.2,20.7,43.5,"Liberty County, Texas",48291,26.492360089431553,18.749348377605042,48291,136.0,3.0
380,0500000US48479,"Webb County, Texas",275910,135706,140204,90659,46092,44567,35638,15676,19962,29.0,96.8,73.3,16.3,56.9,"Webb County, Texas",48479,32.85817839150448,12.916530752781705,48479,578.0,5.0
381,0500000US51095,"James City County, Virginia",76397,35319,41078,15497,6604,8893,25442,11216,14226,46.8,86.0,84.6,47.2,37.5,"James City County, Virginia",51095,20.284827938269828,33.302354804508035,51095,57.0,1.0
382,0500000US51161,"Roanoke County, Virginia",94073,45242,48831,18850,9998,8852,25909,11060,14849,43.4,92.7,69.4,35.5,33.9,"Roanoke County, Virginia",51161,20.037630350897707,27.541377440923537,51161,110.0,1.0
383,0500000US55059,"Kenosha County, Wisconsin",169290,84207,85083,38585,20383,18202,34425,15555,18870,38.8,99.0,58.2,22.1,36.0,"Kenosha County, Wisconsin",55059,22.79224998523244,20.334928229665074,55059,517.0,3.0
384,0500000US06033,"Lake County, California",64382,31318,33064,13510,6500,7010,20179,10115,10064,44.0,94.7,78.8,41.2,37.5,"Lake County, California",06033,20.984125997949736,31.34261128886956,06033,62.0,2.0
385,0500000US06075,"San Francisco County, California",883305,450985,432320,118684,60771,57913,191266,89102,102164,38.3,104.3,41.0,22.0,18.9,"San Francisco County, California",06075,13.436355505742636,21.65344926158009,06075,4828.0,17.0
386,0500000US08123,"Weld County, Colorado",314305,158125,156180,82497,42700,39797,57811,26720,31091,34.6,101.2,62.4,19.7,42.6,"Weld County, Colorado",08123,26.247434816499897,18.393280412338335,08123,300.0,1.0
387,0500000US12005,"Bay County, Florida",185287,91852,93435,39688,20130,19558,44758,20009,24749,39.6,98.3,61.6,27.0,34.6,"Bay County, Florida",12005,21.4197434250649,24.15603900975244,12005,752.0,5.0
388,0500000US13015,"Bartow County, Georgia",106408,52149,54259,25274,13028,12246,21998,9480,12518,38.3,96.1,60.1,22.0,38.0,"Bartow County, Georgia",13015,23.751973535824376,20.673257649800767,13015,80.0,1.0
389,0500000US20015,"Butler County, Kansas",66765,33796,32969,16767,8289,8478,14970,6953,8017,38.8,102.5,67.5,25.4,42.1,"Butler County, Kansas",20015,25.113457649966296,22.42192765670636,20015,126.0,2.0
390,0500000US20103,"Leavenworth County, Kansas",81352,43315,38037,19719,9981,9738,17261,7859,9402,38.6,113.9,64.5,24.6,39.9,"Leavenworth County, Kansas",20103,24.239109056937753,21.21767135411545,20103,130.0,2.0
391,0500000US20161,"Riley County, Kansas",73703,38718,34985,12188,5981,6207,10190,4655,5535,25.0,110.7,35.3,12.9,22.4,"Riley County, Kansas",20161,16.53664029958075,13.825760145448626,20161,109.0,2.0
392,0500000US25015,"Hampshire County, Massachusetts",161355,75097,86258,23568,12061,11507,38106,16681,21425,37.6,87.1,46.9,25.5,21.5,"Hampshire County, Massachusetts",25015,14.606302872548108,23.6162498837966,25015,165.0,2.0
393,0500000US29031,"Cape Girardeau County, Missouri",78753,38155,40598,17037,8721,8316,17851,8017,9834,36.0,94.0,61.5,26.6,34.9,"Cape Girardeau County, Missouri",29031,21.633461582415908,22.667073000393636,29031,601.0,3.0
394,0500000US36001,"Albany County, New York",307117,149679,157438,56517,29824,26693,72597,32626,39971,37.9,95.1,54.9,26.4,28.5,"Albany County, New York",36001,18.402432949006407,23.638222566643982,36001,1381.0,5.0
395,0500000US36029,"Erie County, New York",919719,444847,474872,186092,94602,91490,229844,100378,129466,40.3,93.7,61.8,29.1,32.7,"Erie County, New York",36029,20.233571340811704,24.990676500104925,36029,2788.0,12.0
396,0500000US37045,"Cleveland County, North Carolina",97645,46759,50886,21657,10824,10833,26181,11771,14410,42.0,91.9,68.7,31.3,37.4,"Cleveland County, North Carolina",37045,22.179323058016283,26.812432792257667,37045,431.0,4.0
397,0500000US39109,"Miami County, Ohio",106222,52551,53671,24786,13062,11724,27819,12617,15202,42.0,97.9,74.4,33.7,40.7,"Miami County, Ohio",39109,23.33414923462183,26.189489936171416,39109,193.0,1.0
398,0500000US39145,"Scioto County, Ohio",75502,37439,38063,16503,8208,8295,18648,8085,10563,40.3,98.4,66.0,29.7,36.3,"Scioto County, Ohio",39145,21.85769913379778,24.698683478583348,39145,446.0,2.0
399,0500000US41005,"Clackamas County, Oregon",416075,205716,210359,89564,46426,43138,103663,48285,55378,41.4,97.8,65.2,29.6,35.6,"Clackamas County, Oregon",41005,21.525926816078833,24.914498587994952,41005,551.0,4.0
400,0500000US45077,"Pickens County, South Carolina",124937,63006,61931,23642,12984,10658,27795,12161,15634,36.7,101.7,55.0,25.7,29.3,"Pickens County, South Carolina",45077,18.923137261179633,22.247212595147957,45077,164.0,2.0
401,0500000US47163,"Sullivan County, Tennessee",157668,76241,81427,30788,15390,15398,47781,22120,25661,45.2,93.6,71.2,37.8,33.4,"Sullivan County, Tennessee",47163,19.52710759317046,30.3048177182434,47163,1175.0,5.0
402,0500000US53027,"Grays Harbor County, Washington",73901,37073,36828,15099,6992,8107,22171,10205,11966,44.5,100.7,73.9,38.4,35.5,"Grays Harbor County, Washington",53027,20.43138793791694,30.00094721316356,53027,154.0,3.0
403,0500000US05031,"Craighead County, Arkansas",108558,53182,55376,27150,14217,12933,21122,8788,12334,34.0,96.0,63.9,22.9,41.0,"Craighead County, Arkansas",05031,25.009672248936056,19.45688019307651,05031,631.0,4.0
404,0500000US06071,"San Bernardino County, California",2171603,1081214,1090389,572279,292906,279373,365995,166227,199768,33.6,99.2,61.1,18.6,42.4,"San Bernardino County, California",06071,26.352837051707883,16.853679056438953,06071,5929.0,29.0
405,0500000US12099,"Palm Beach County, Florida",1485941,719591,766350,283443,144484,138959,450975,203525,247450,44.9,93.9,75.3,41.9,33.4,"Palm Beach County, Florida",12099,19.074983461658302,30.349455328307112,12099,4993.0,20.0
406,0500000US12107,"Putnam County, Florida",74163,36614,37549,15757,8262,7495,22649,11106,11543,44.9,97.5,80.5,42.1,38.3,"Putnam County, Florida",12107,21.24644364440489,30.539487345441795,12107,99.0,1.0
407,0500000US13117,"Forsyth County, Georgia",236612,117349,119263,64825,33295,31530,39775,18157,21618,38.8,98.4,65.0,19.8,45.2,"Forsyth County, Georgia",13117,27.397173431609556,16.810220952445356,13117,187.0,1.0
408,0500000US13121,"Fulton County, Georgia",1050114,508879,541235,229550,116856,112694,179262,77672,101590,35.6,94.0,50.5,17.6,32.9,"Fulton County, Georgia",13121,21.859531441348274,17.070718036327484,13121,4902.0,18.0
409,0500000US17097,"Lake County, Illinois",700832,350487,350345,168695,86309,82386,144715,67154,77561,38.5,100.0,62.1,23.1,39.0,"Lake County, Illinois",17097,24.07067599652984,20.649028583169716,17097,968.0,6.0
410,0500000US20173,"Sedgwick County, Kansas",513607,254546,259061,131921,67624,64297,106010,48687,57323,35.7,98.3,67.1,24.2,42.9,"Sedgwick County, Kansas",20173,25.685202888589913,20.64029501155553,20173,1140.0,11.0
411,0500000US26005,"Allegan County, Michigan",117327,58153,59174,28357,14224,14133,26714,12361,14353,40.2,98.3,69.6,28.6,41.0,"Allegan County, Michigan",26005,24.169202314897678,22.768842636392307,26005,68.0,2.0
412,0500000US26081,"Kent County, Michigan",653786,321933,331853,157809,81010,76799,129177,58406,70771,35.5,97.0,60.9,22.1,38.8,"Kent County, Michigan",26081,24.1377147874075,19.7583001165519,26081,1860.0,8.0
413,0500000US29037,"Cass County, Missouri",104954,50586,54368,25142,13311,11831,25315,10755,14560,41.0,93.0,69.8,29.1,40.7,"Cass County, Missouri",29037,23.955256588600722,24.12009070640471,29037,106.0,2.0
414,0500000US29189,"St. Louis County, Missouri",996945,472353,524592,219527,111844,107683,251590,109050,142540,40.4,90.0,67.0,30.2,36.8,"St. Louis County, Missouri",29189,22.01997101143995,25.236096274117433,29189,4928.0,20.0
415,0500000US34005,"Burlington County, New Jersey",445384,218445,226939,92802,46595,46207,106464,47155,59309,41.7,96.3,60.6,27.1,33.5,"Burlington County, New Jersey",34005,20.836401846496504,23.903867224687012,34005,1112.0,9.0
416,0500000US34007,"Camden County, New Jersey",507078,243014,264064,114758,57216,57542,112307,48391,63916,38.8,92.0,62.0,25.3,36.7,"Camden County, New Jersey",34007,22.631232275902327,22.14787468594575,34007,2828.0,10.0
417,0500000US35035,"Otero County, New Mexico",66781,34882,31899,15459,7890,7569,15097,7000,8097,36.2,109.4,64.5,26.4,38.1,"Otero County, New Mexico",35035,23.148799808328715,22.606729458977853,35035,112.0,2.0
418,0500000US37071,"Gaston County, North Carolina",222846,107209,115637,50165,25323,24842,49424,21084,28340,40.2,92.7,62.3,25.8,36.5,"Gaston County, North Carolina",37071,22.511061450508425,22.178544824677132,37071,475.0,2.0
419,0500000US37171,"Surry County, North Carolina",71948,35224,36724,15196,7879,7317,20344,9517,10827,44.2,95.9,72.6,36.1,36.5,"Surry County, North Carolina",37171,21.120809473508643,28.2759770945683,37171,226.0,2.0
420,0500000US42091,"Montgomery County, Pennsylvania",828604,403331,425273,178132,91045,87087,202380,89845,112535,41.2,94.8,64.6,29.2,35.4,"Montgomery County, Pennsylvania",42091,21.497844567489416,24.42421228958586,42091,3580.0,16.0
421,0500000US46099,"Minnehaha County, South Dakota",192876,98105,94771,49051,25430,23621,36828,17016,19812,35.7,103.5,62.8,21.4,41.4,"Minnehaha County, South Dakota",46099,25.431365229473858,19.0941330181049,46099,1174.0,7.0
422,0500000US47149,"Rutherford County, Tennessee",324890,159823,165067,79886,40796,39090,49499,21927,27572,33.8,96.8,53.6,15.9,37.8,"Rutherford County, Tennessee",47149,24.588629997845423,15.235618209240052,47149,387.0,2.0
423,0500000US47187,"Williamson County, Tennessee",231729,114088,117641,63088,32264,30824,43840,20843,22997,39.5,97.0,68.1,22.3,45.8,"Williamson County, Tennessee",47187,27.224904953631178,18.918650665216695,47187,225.0,2.0
424,0500000US48183,"Gregg County, Texas",123707,59025,64682,31716,15360,16356,26516,11685,14831,35.5,91.3,69.4,26.0,43.4,"Gregg County, Texas",48183,25.637999466481283,21.434518661029692,48183,846.0,6.0
425,0500000US48347,"Nacogdoches County, Texas",65711,32131,33580,15350,8187,7163,12798,5896,6902,31.8,95.7,61.0,23.4,37.6,"Nacogdoches County, Texas",48347,23.359863645356178,19.476191200864392,48347,390.0,3.0
426,0500000US48439,"Tarrant County, Texas",2084931,1019965,1064966,548633,278883,269750,349189,160492,188697,34.6,95.8,60.3,18.1,42.2,"Tarrant County, Texas",48439,26.314204163111395,16.748228118820236,48439,6814.0,54.0
428,0500000US55089,"Ozaukee County, Wisconsin",89147,43951,45196,18961,9960,9001,25377,11823,13554,44.3,97.2,69.8,33.7,36.1,"Ozaukee County, Wisconsin",55089,21.269364084040966,28.466465500802045,55089,326.0,3.0
429,0500000US55133,"Waukesha County, Wisconsin",403072,198175,204897,86697,44706,41991,107405,48490,58915,43.2,96.7,67.0,31.1,35.9,"Waukesha County, Wisconsin",55133,21.50906041600508,26.64660408066053,55133,1305.0,9.0
430,0500000US06065,"Riverside County, California",2450758,1221553,1229205,616127,314558,301569,482864,225118,257746,35.8,99.4,65.4,23.8,41.6,"Riverside County, California",06065,25.140262726878788,19.70263893864674,06065,3945.0,24.0
431,0500000US06085,"Santa Clara County, California",1937570,982419,955151,423735,217382,206353,369590,169836,199754,37.2,102.9,54.7,20.9,33.8,"Santa Clara County, California",06085,21.86940342800518,19.074923744690516,06085,3831.0,16.0
432,0500000US06099,"Stanislaus County, California",549815,272319,277496,148801,76005,72796,101077,45103,55974,34.5,98.1,67.4,22.1,45.3,"Stanislaus County, California",06099,27.063830561188762,18.383820012185918,06099,1729.0,12.0
433,0500000US08101,"Pueblo County, Colorado",167529,81804,85725,37486,18995,18491,42778,19736,23042,39.4,95.4,68.9,31.1,37.8,"Pueblo County, Colorado",08101,22.375827468677066,25.534683547326136,08101,1292.0,3.0
434,0500000US12053,"Hernando County, Florida",190865,91394,99471,35153,17403,17750,67787,30866,36921,49.1,91.9,85.2,51.1,34.1,"Hernando County, Florida",12053,18.41772980902732,35.51567862101485,12053,620.0,5.0
435,0500000US12101,"Pasco County, Florida",539630,261830,277800,109471,55221,54250,157556,72151,85405,44.5,94.3,75.2,39.7,35.5,"Pasco County, Florida",12101,20.286307284620943,29.19704241795304,12101,1440.0,10.0
436,0500000US12115,"Sarasota County, Florida",426718,203878,222840,60574,31479,29095,189899,88076,101823,56.5,91.5,104.1,75.1,29.0,"Sarasota County, Florida",12115,14.195323375156427,44.50222395118087,12115,1618.0,7.0
437,0500000US12119,"Sumter County, Florida",128754,64120,64634,9257,4296,4961,84858,40088,44770,67.5,99.2,177.8,157.9,20.0,"Sumter County, Florida",12119,7.189679543936498,65.90707861503333,12119,339.0,2.0
438,0500000US18011,"Boone County, Indiana",66999,33267,33732,17674,9011,8663,13223,6137,7086,37.9,98.6,65.1,21.6,43.6,"Boone County, Indiana",18011,26.379498201465694,19.736115464409917,18011,52.0,1.0
439,0500000US26091,"Lenawee County, Michigan",98266,49510,48756,20655,10598,10057,25564,11645,13919,41.3,101.5,65.1,30.4,34.7,"Lenawee County, Michigan",26091,21.019477744082387,26.015101866362727,26091,113.0,2.0
440,0500000US29183,"St. Charles County, Missouri",399182,196522,202660,92672,47456,45216,86886,39462,47424,38.7,97.0,61.7,24.2,37.5,"St. Charles County, Missouri",29183,23.215475647699545,21.766011493504216,29183,852.0,7.0
441,0500000US29187,"St. Francois County, Missouri",66692,34634,32058,14116,6653,7463,14902,7168,7734,40.2,108.0,61.7,27.5,34.2,"St. Francois County, Missouri",29187,21.16595693636418,22.344509086547113,29187,231.0,3.0
442,0500000US36059,"Nassau County, New York",1358343,661642,696701,291228,149294,141934,335773,149465,186308,41.7,95.0,64.5,29.2,35.3,"Nassau County, New York",36059,21.439945580755378,24.719308746023646,36059,4343.0,12.0
443,0500000US36071,"Orange County, New York",381951,192029,189922,97252,50373,46879,77277,35084,42193,36.9,101.1,65.1,23.1,42.0,"Orange County, New York",36071,25.461904799306716,20.232176378645427,36071,902.0,5.0
444,0500000US37133,"Onslow County, North Carolina",197683,108587,89096,48419,24412,24007,24911,11448,13463,26.5,121.9,50.6,13.7,36.9,"Onslow County, North Carolina",37133,24.493254351664028,12.601488241275172,37133,162.0,1.0
445,0500000US39113,"Montgomery County, Ohio",532331,257229,275102,117544,61065,56479,130456,56935,73521,39.2,93.5,66.8,30.0,36.8,"Montgomery County, Ohio",39113,22.080998476511795,24.506557010581762,39113,3458.0,17.0
446,0500000US45045,"Greenville County, South Carolina",514213,250343,263870,118030,60803,57227,113382,50898,62484,38.4,94.9,63.1,25.7,37.4,"Greenville County, South Carolina",45045,22.95352315091217,22.049617570928778,45045,1760.0,12.0
447,0500000US47059,"Greene County, Tennessee",69087,33947,35140,13063,6705,6358,20716,9351,11365,44.5,96.6,67.6,35.9,31.7,"Greene County, Tennessee",47059,18.9080434814075,29.985380751805696,47059,240.0,2.0
448,0500000US48041,"Brazos County, Texas",226758,115417,111341,46903,24571,22332,28809,13291,15518,26.9,103.7,42.7,13.2,29.5,"Brazos County, Texas",48041,20.684165498019915,12.704733680840366,48041,658.0,6.0
449,0500000US48209,"Hays County, Texas",222631,111088,111543,49928,25310,24618,35109,15680,19429,32.0,99.6,50.6,16.8,33.8,"Hays County, Texas",48209,22.426346735180637,15.77004100956291,48209,354.0,4.0
450,0500000US51059,"Fairfax County, Virginia",1150795,570773,580022,269098,137678,131420,222650,105375,117275,38.0,98.4,58.3,21.3,37.0,"Fairfax County, Virginia",51059,23.383660860535542,19.34749455810983,51059,1708.0,7.0
451,0500000US12081,"Manatee County, Florida",394855,191284,203571,72457,37429,35028,137168,63310,73858,48.7,94.0,84.0,50.2,33.8,"Manatee County, Florida",12081,18.350280482708843,34.738828177432225,12081,806.0,5.0
452,0500000US13057,"Cherokee County, Georgia",254149,125287,128862,62094,31796,30298,50591,23272,27319,38.6,97.2,63.1,23.2,39.8,"Cherokee County, Georgia",13057,24.43212446242165,19.906039370605434,13057,79.0,1.0
453,0500000US13215,"Muscogee County, Georgia",194160,94670,99490,48112,24802,23310,38019,16289,21730,34.2,95.2,61.9,21.7,40.1,"Muscogee County, Georgia",13215,24.779563246806756,19.581273176761435,13215,1374.0,6.0
454,0500000US15001,"Hawaii County, Hawaii",200983,98970,102013,43630,21658,21972,58846,28581,30265,42.5,97.0,75.2,37.2,38.0,"Hawaii County, Hawaii",15001,21.708303687376546,29.279093256643595,15001,504.0,6.0
455,0500000US18127,"Porter County, Indiana",169594,84184,85410,37422,19721,17701,39205,18439,20766,39.6,98.6,61.9,26.1,35.7,"Porter County, Indiana",18127,22.065639114591317,23.1169734778353,18127,317.0,2.0
456,0500000US22057,"Lafourche Parish, Louisiana",98115,47188,50927,22982,11235,11747,22897,9879,13018,38.1,92.7,64.6,26.1,38.6,"Lafourche Parish, Louisiana",22057,23.423533608520614,23.336900575854862,22057,203.0,3.0
457,0500000US24510,"Baltimore city, Maryland",602495,282677,319818,123114,62430,60684,124044,50658,73386,35.5,88.4,52.4,21.3,31.1,"Baltimore city, Maryland",24510,20.434028498161812,20.58838662561515,24510,4697.0,16.0
458,0500000US36083,"Rensselaer County, New York",159442,78766,80676,31179,15992,15187,37660,17413,20247,39.4,97.6,56.8,26.1,30.7,"Rensselaer County, New York",36083,19.555073318197213,23.61987431166192,36083,423.0,3.0
459,0500000US37057,"Davidson County, North Carolina",166614,81141,85473,36641,18123,18518,42887,19581,23306,42.2,94.9,66.7,30.1,36.7,"Davidson County, North Carolina",37057,21.99154932958815,25.74033394552679,37057,243.0,2.0
460,0500000US39089,"Licking County, Ohio",175769,85511,90258,40809,20664,20145,40277,18547,21730,39.8,94.7,65.5,27.0,38.4,"Licking County, Ohio",39089,23.21740466180043,22.914734680176824,39089,262.0,3.0
461,0500000US41029,"Jackson County, Oregon",219564,106611,112953,44571,22385,22186,65130,29218,35912,42.9,94.4,73.8,38.5,35.3,"Jackson County, Oregon",41029,20.299775919549653,29.66333278679565,41029,545.0,3.0
462,0500000US42063,"Indiana County, Pennsylvania",84501,42527,41974,14818,7669,7149,22679,10506,12173,40.6,101.3,59.3,31.3,27.9,"Indiana County, Pennsylvania",42063,17.535887149264507,26.83873563626466,42063,164.0,1.0
463,0500000US45007,"Anderson County, South Carolina",200482,97343,103139,45426,23786,21640,48417,21685,26732,40.6,94.4,68.3,30.2,38.1,"Anderson County, South Carolina",45007,22.658393272213964,24.15029778234455,45007,755.0,4.0
464,0500000US48135,"Ector County, Texas",162124,82718,79406,48934,24939,23995,23546,11715,11831,30.9,104.2,65.4,15.5,49.9,"Ector County, Texas",48135,30.18306974908095,14.523451185512323,48135,1016.0,5.0
465,0500000US48423,"Smith County, Texas",230221,111659,118562,56559,29854,26705,52104,22974,29130,36.7,94.2,69.2,27.6,41.6,"Smith County, Texas",48423,24.56726362929533,22.632166483509327,48423,1337.0,10.0
466,0500000US48469,"Victoria County, Texas",92035,44268,47767,23694,11410,12284,20646,9520,11126,36.4,92.7,72.3,28.0,44.4,"Victoria County, Texas",48469,25.744553702395827,22.432770141793885,48469,723.0,6.0
467,0500000US55127,"Walworth County, Wisconsin",103718,52101,51617,21242,11079,10163,24941,11936,13005,40.1,100.9,61.2,28.2,33.0,"Walworth County, Wisconsin",55127,20.48053375498949,24.046934958252184,55127,134.0,2.0
468,0500000US01127,"Walker County, Alabama",63711,31070,32641,13976,7375,6601,15264,6517,8747,41.5,95.2,69.1,32.0,37.1,"Walker County, Alabama",01127,21.936557266406115,23.958186184489335,01127,267.0,1.0
469,0500000US05007,"Benton County, Arkansas",272608,135116,137492,71569,36340,35229,51109,22970,28139,35.5,98.3,65.5,22.0,43.4,"Benton County, Arkansas",05007,26.253448174668385,18.74816586453809,05007,335.0,3.0
470,0500000US06101,"Sutter County, California",96807,47630,49177,24983,12653,12330,21337,9715,11622,35.7,96.9,70.0,26.1,43.9,"Sutter County, California",06101,25.807018087534995,22.04076151517969,06101,92.0,4.0
471,0500000US08001,"Adams County, Colorado",511868,258354,253514,135775,69280,66495,77551,35662,41889,34.0,101.9,58.5,16.4,42.0,"Adams County, Colorado",08001,26.525393265451246,15.150585697875233,08001,716.0,6.0
472,0500000US12087,"Monroe County, Florida",75027,38491,36536,11243,5588,5655,22772,11795,10977,48.1,105.4,60.3,36.3,24.0,"Monroe County, Florida",12087,14.985271968757912,30.351740040252178,12087,148.0,4.0
473,0500000US12095,"Orange County, Florida",1380645,677889,702756,305594,156417,149177,240255,107503,132752,35.3,96.5,51.7,18.1,33.6,"Orange County, Florida",12095,22.134147445577973,17.40164922916463,12095,4751.0,16.0
474,0500000US13077,"Coweta County, Georgia",145864,73040,72824,34644,19263,15381,30015,13758,16257,38.3,100.3,61.2,22.9,38.3,"Coweta County, Georgia",13077,23.750891241156147,20.57738715515823,13077,211.0,3.0
475,0500000US17099,"LaSalle County, Illinois",109430,55242,54188,23327,11926,11401,28235,13162,15073,41.9,101.9,67.7,31.9,35.7,"LaSalle County, Illinois",17099,21.31682354016266,25.80188248195193,17099,269.0,4.0
476,0500000US19113,"Linn County, Iowa",225909,111575,114334,52580,27315,25265,48986,22454,26532,37.8,97.6,65.0,26.6,38.4,"Linn County, Iowa",19113,23.27485846070763,21.683952387908406,19113,994.0,2.0
477,0500000US27013,"Blue Earth County, Minnesota",67427,33429,33998,13316,6523,6793,12383,5582,6801,30.6,98.3,51.0,21.2,29.8,"Blue Earth County, Minnesota",27013,19.748765331395436,18.365046643036173,27013,272.0,1.0
478,0500000US28047,"Harrison County, Mississippi",206650,101653,104997,49415,25307,24108,42377,19026,23351,36.8,96.8,63.7,24.5,39.1,"Harrison County, Mississippi",28047,23.912412291313814,20.50665376240019,28047,867.0,5.0
479,0500000US28049,"Hinds County, Mississippi",237085,110488,126597,56752,28787,27965,48092,20690,27402,35.1,87.3,61.2,22.6,38.6,"Hinds County, Mississippi",28049,23.93740641542063,20.284708016112365,28049,2463.0,8.0
480,0500000US29099,"Jefferson County, Missouri",224347,111579,112768,51654,26338,25316,50470,23541,26929,39.7,98.9,61.6,24.4,37.2,"Jefferson County, Missouri",29099,23.0241545463055,22.496400665041207,29099,251.0,1.0
481,0500000US33009,"Grafton County, New Hampshire",89786,43749,46037,14376,7068,7308,25182,12143,13039,42.7,95.0,58.1,32.8,25.3,"Grafton County, New Hampshire",33009,16.011404896086248,28.046688793353088,33009,496.0,5.0
482,0500000US36013,"Chautauqua County, New York",127939,63814,64125,25570,13349,12221,35067,15953,19114,42.4,99.5,66.6,33.3,33.3,"Chautauqua County, New York",36013,19.986087119642953,27.40915592587092,36013,399.0,5.0
483,0500000US37067,"Forsyth County, North Carolina",379099,180429,198670,86658,44858,41800,83465,36537,46928,38.5,90.8,63.4,26.0,37.3,"Forsyth County, North Carolina",37067,22.85893658384749,22.016676382686317,37067,1855.0,4.0
484,0500000US39025,"Clermont County, Ohio",205466,100815,104651,47609,24381,23228,47424,21402,26022,39.9,96.3,64.5,26.4,38.1,"Clermont County, Ohio",39025,23.171230276542104,23.08119104864065,39025,148.0,1.0
485,0500000US39041,"Delaware County, Ohio",204826,101021,103805,54159,27719,26440,39972,18444,21528,38.7,97.3,66.4,22.4,44.0,"Delaware County, Ohio",39041,26.441467391835022,19.515100621991348,39041,212.0,2.0
486,0500000US39049,"Franklin County, Ohio",1310300,639445,670855,304644,155007,149637,231219,102302,128917,34.1,95.3,54.5,18.6,35.9,"Franklin County, Ohio",39049,23.249942761199723,17.646264214302068,39049,6376.0,22.0
487,0500000US39103,"Medina County, Ohio",179146,89213,89933,40256,21298,18958,43432,19940,23492,41.9,99.2,67.7,30.0,37.7,"Medina County, Ohio",39103,22.471057126589486,24.243912786219063,39103,241.0,3.0
488,0500000US47011,"Bradley County, Tennessee",106727,52403,54324,23230,12553,10677,24126,10409,13717,40.1,96.5,63.0,27.5,35.5,"Bradley County, Tennessee",47011,21.765813711619366,22.60533885521002,47011,348.0,2.0
489,0500000US48021,"Bastrop County, Texas",86976,44143,42833,22094,11518,10576,19416,9772,9644,38.1,103.1,65.4,23.4,42.0,"Bastrop County, Texas",48021,25.402409860191316,22.323399558498895,48021,838.0,14.0
490,0500000US48355,"Nueces County, Texas",362265,179696,182569,88910,46001,42909,74996,34360,40636,35.7,98.4,64.2,23.9,40.3,"Nueces County, Texas",48355,24.542807061129285,20.701972313085726,48355,2224.0,14.0
491,0500000US53005,"Benton County, Washington",201877,99991,101886,53999,26590,27409,42090,19571,22519,35.8,98.1,71.4,25.5,45.8,"Benton County, Washington",53005,26.748465649875914,20.84932904689489,53005,447.0,4.0
492,0500000US53073,"Whatcom County, Washington",225685,111469,114216,44119,22517,21602,54103,25990,28113,37.2,97.6,58.7,27.7,31.0,"Whatcom County, Washington",53073,19.548928816713563,23.97279393845404,53073,253.0,1.0
493,0500000US04001,"Apache County, Arizona",71818,35613,36205,19517,10019,9498,15270,7348,7922,35.4,98.4,73.6,26.4,47.2,"Apache County, Arizona",04001,27.175638419337773,21.262079144504163,04001,45.0,2.0
494,0500000US04015,"Mohave County, Arizona",209550,105596,103954,35609,17767,17842,82568,41187,41381,52.5,101.6,90.2,57.9,32.3,"Mohave County, Arizona",04015,16.993080410403245,39.40252922930088,04015,588.0,4.0
495,0500000US04019,"Pima County, Arizona",1039073,510267,528806,216294,109784,106510,271445,123771,147674,39.0,96.5,68.3,33.3,35.0,"Pima County, Arizona",04019,20.816054309947425,26.12376608765698,04019,3157.0,16.0
496,0500000US05143,"Washington County, Arkansas",236961,118088,118873,57013,28988,28025,39312,18016,21296,32.2,99.3,54.9,17.6,37.3,"Washington County, Arkansas",05143,24.06007739670241,16.59007178396445,05143,876.0,7.0
497,0500000US06095,"Solano County, California",446610,222472,224138,99231,51045,48186,101130,46176,54954,38.5,99.3,61.4,25.5,35.9,"Solano County, California",06095,22.218714314502584,22.643917511923153,06095,749.0,7.0
498,0500000US11001,"District of Columbia, District of Columbia",702455,334208,368247,127214,65056,62158,118779,50152,68627,33.9,90.8,43.5,17.5,26.0,"District of Columbia, District of Columbia",11001,18.10991451409699,16.90912585147803,11001,4304.0,14.0
499,0500000US12109,"St. Johns County, Florida",254261,124435,129826,54889,27942,26947,69765,32761,37004,44.3,95.8,72.2,35.0,37.2,"St. Johns County, Florida",12109,21.587659924251064,27.43834091740377,12109,335.0,1.0
500,0500000US16083,"Twin Falls County, Idaho",86081,43370,42711,23536,12576,10960,18365,8094,10271,35.3,101.5,73.5,26.0,47.4,"Twin Falls County, Idaho",16083,27.341689803789453,21.334556987023852,16083,253.0,2.0
501,0500000US17115,"Macon County, Illinois",104712,50279,54433,23097,11809,11288,29854,13756,16098,40.9,92.4,73.2,35.0,38.2,"Macon County, Illinois",17115,22.05764382305753,28.51058140423256,17115,188.0,1.0
502,0500000US18167,"Vigo County, Indiana",107386,54555,52831,21693,11531,10162,23654,10434,13220,36.3,103.3,56.6,25.0,31.6,"Vigo County, Indiana",18167,20.200957294246923,22.027079880058853,18167,541.0,4.0
503,0500000US21037,"Campbell County, Kentucky",93152,45006,48146,19403,9859,9544,21340,9522,11818,38.5,93.5,58.1,25.2,32.9,"Campbell County, Kentucky",21037,20.82939711439368,22.908794228787357,21037,284.0,1.0
504,0500000US22019,"Calcasieu Parish, Louisiana",203112,98084,105028,50285,25211,25074,44633,19495,25138,36.2,93.4,66.0,24.9,41.1,"Calcasieu Parish, Louisiana",22019,24.757276773405806,21.974575603607864,22019,788.0,8.0
505,0500000US22097,"St. Landry Parish, Louisiana",82764,40269,42495,22260,11874,10386,18685,8442,10243,37.0,94.8,74.8,27.8,47.0,"St. Landry Parish, Louisiana",22097,26.895751776134553,22.576240877676284,22097,605.0,4.0
506,0500000US25023,"Plymouth County, Massachusetts",518132,252706,265426,110245,56624,53621,131153,58685,72468,43.0,95.2,64.9,29.8,35.1,"Plymouth County, Massachusetts",25023,21.277396493557628,25.312661638346984,25023,872.0,7.0
508,0500000US30049,"Lewis and Clark County, Montana",68700,33854,34846,14986,7755,7231,17751,8470,9281,40.8,97.2,67.4,30.9,36.5,"Lewis and Clark County, Montana",30049,21.8136826783115,25.83842794759825,30049,143.0,2.0
509,0500000US35025,"Lea County, New Mexico",69611,35698,33913,20628,10734,9894,11628,5624,6004,32.2,105.3,69.3,19.1,50.2,"Lea County, New Mexico",35025,29.6332476189108,16.704256511183576,35025,211.0,2.0
510,0500000US39157,"Tuscarawas County, Ohio",92176,44815,47361,21059,10372,10687,24751,11064,13687,41.0,94.6,73.6,34.0,39.7,"Tuscarawas County, Ohio",39157,22.846511022391947,26.851892032633224,39157,198.0,3.0
511,0500000US40125,"Pottawatomie County, Oklahoma",72679,34613,38066,17153,8371,8782,16970,8001,8969,37.5,90.9,66.3,27.0,39.2,"Pottawatomie County, Oklahoma",40125,23.601040190426396,23.349248063402083,40125,136.0,2.0
512,0500000US45091,"York County, South Carolina",274118,132457,141661,66497,34409,32088,54989,24805,30184,39.0,93.5,62.9,23.4,39.5,"York County, South Carolina",45091,24.25853099759957,20.06033897810432,45091,334.0,2.0
513,0500000US48441,"Taylor County, Texas",137640,66929,70711,34211,16959,17252,27501,12534,14967,33.4,94.7,63.8,23.1,40.7,"Taylor County, Texas",48441,24.855419936065097,19.980383609415867,48441,956.0,6.0
514,0500000US48471,"Walker County, Texas",72480,40366,32114,10927,5934,4993,13495,6792,6703,37.2,125.7,38.5,17.6,20.9,"Walker County, Texas",48471,15.075883002207505,18.6189293598234,48471,123.0,1.0
515,0500000US50007,"Chittenden County, Vermont",164572,80265,84307,29165,14689,14476,36970,16702,20268,36.0,95.2,50.6,23.9,26.7,"Chittenden County, Vermont",50007,17.721726660671315,22.464331721070412,50007,562.0,1.0
516,0500000US51740,"Portsmouth city, Virginia",94632,46138,48494,21850,11619,10231,19325,8612,10713,35.3,95.1,60.8,23.7,37.1,"Portsmouth city, Virginia",51740,23.089441203821117,20.421210584157578,51740,346.0,1.0
517,0500000US54107,"Wood County, West Virginia",84203,40763,43440,17812,9111,8701,22270,10416,11854,43.4,93.8,71.1,34.9,36.2,"Wood County, West Virginia",54107,21.153640606629217,26.447988788998018,54107,313.0,2.0
518,0500000US56025,"Natrona County, Wyoming",79115,39805,39310,18914,10015,8899,16960,8130,8830,37.2,101.3,63.8,24.6,39.2,"Natrona County, Wyoming",56025,23.906970865196232,21.437148454781017,56025,377.0,5.0
519,0500000US01055,"Etowah County, Alabama",102501,48830,53671,22032,10814,11218,27509,12270,15239,41.3,91.0,68.5,32.3,36.2,"Etowah County, Alabama",01055,21.494424444639566,26.837786948420018,01055,739.0,4.0
520,0500000US01081,"Lee County, Alabama",163941,80832,83109,34795,17947,16848,29162,13008,16154,32.1,97.3,50.0,18.2,31.8,"Lee County, Alabama",01081,21.22409891363356,17.788106696921453,01081,314.0,1.0
521,0500000US02020,"Anchorage Municipality, Alaska",291538,148668,142870,71338,36696,34642,48692,23916,24776,34.3,104.1,55.6,17.5,38.1,"Anchorage Municipality, Alaska",02020,24.469537418792747,16.701767865595567,02020,988.0,6.0
522,0500000US08031,"Denver County, Colorado",716492,358836,357656,139699,70606,69093,118333,53486,64847,34.6,100.3,45.4,17.0,28.3,"Denver County, Colorado",08031,19.497635702841066,16.515606594351368,08031,2442.0,14.0
523,0500000US12021,"Collier County, Florida",378488,185300,193188,64531,32171,32360,149247,69160,80087,51.6,95.9,97.7,64.0,33.7,"Collier County, Florida",12021,17.049681892160386,39.432425862907145,12021,1051.0,6.0
524,0500000US12086,"Miami-Dade County, Florida",2761581,1339698,1421883,558719,283661,275058,607283,260585,346698,40.1,94.2,57.4,25.5,31.8,"Miami-Dade County, Florida",12086,20.231852695973792,21.990410565541985,12086,10243.0,38.0
525,0500000US18097,"Marion County, Indiana",954670,459149,495521,235211,119989,115222,173672,75662,98010,34.5,92.7,59.3,20.0,39.2,"Marion County, Indiana",18097,24.637937716697916,18.191835922360607,18097,3640.0,17.0
526,0500000US20045,"Douglas County, Kansas",121436,59910,61526,21734,10375,11359,20838,9243,11595,30.2,97.4,43.9,18.1,25.8,"Douglas County, Kansas",20045,17.89749332981982,17.159656115155308,20045,152.0,1.0
527,0500000US22063,"Livingston Parish, Louisiana",139567,68578,70989,35705,18315,17390,28112,13069,15043,37.1,96.6,64.3,22.3,42.0,"Livingston Parish, Louisiana",22063,25.5826950496894,20.142297247916773,22063,59.0,1.0
528,0500000US26037,"Clinton County, Michigan",79332,39134,40198,17755,9059,8696,19268,9045,10223,40.0,97.4,65.4,28.4,37.0,"Clinton County, Michigan",26037,22.380628245852872,24.28780315635557,26037,25.0,1.0
529,0500000US28059,"Jackson County, Mississippi",143277,71037,72240,33631,18117,15514,32610,14657,17953,39.0,98.3,64.9,26.2,38.7,"Jackson County, Mississippi",28059,23.472713694452004,22.7601080424632,28059,571.0,2.0
530,0500000US36019,"Clinton County, New York",80695,42358,38337,14181,7350,6831,19879,9816,10063,39.5,110.5,52.3,25.5,26.8,"Clinton County, New York",36019,17.573579527851788,24.63473573331681,36019,300.0,1.0
531,0500000US36061,"New York County, New York",1628701,770362,858339,232979,117205,115774,360291,150194,210097,37.6,89.8,44.5,23.9,20.7,"New York County, New York",36061,14.304589976920257,22.121371571577594,36061,11052.0,23.0
532,0500000US36091,"Saratoga County, New York",230163,113339,116824,46199,23489,22710,55084,25968,29116,42.8,97.0,60.8,28.5,32.3,"Saratoga County, New York",36091,20.07229658980809,23.932604284789473,36091,259.0,2.0
533,0500000US37001,"Alamance County, North Carolina",166436,78955,87481,36955,19018,17937,38922,16426,22496,39.8,90.3,64.6,28.1,36.6,"Alamance County, North Carolina",37001,22.20372996226778,23.385565622821986,37001,238.0,1.0
534,0500000US37101,"Johnston County, North Carolina",202675,98113,104562,51796,26136,25660,38740,16218,22522,38.0,93.8,64.1,22.2,41.9,"Johnston County, North Carolina",37101,25.556186012088318,19.11434562723572,37101,199.0,1.0
535,0500000US37135,"Orange County, North Carolina",146027,66535,79492,28863,12965,15898,29182,12668,16514,35.6,83.7,51.5,21.5,29.9,"Orange County, North Carolina",37135,19.76552281427407,19.98397556616242,37135,896.0,1.0
536,0500000US37179,"Union County, North Carolina",235908,115848,120060,63641,32120,31521,41891,18941,22950,37.9,96.5,65.6,20.9,44.7,"Union County, North Carolina",37179,26.97704189768893,17.75734608406667,37179,227.0,1.0
537,0500000US38035,"Grand Forks County, North Dakota",70770,37447,33323,14928,8582,6346,12831,6021,6810,30.3,112.4,50.6,18.9,31.8,"Grand Forks County, North Dakota",38035,21.09368376430691,18.130563798219583,38035,641.0,5.0
538,0500000US39017,"Butler County, Ohio",382378,188087,194291,90001,46415,43586,80953,37105,43848,37.3,96.8,62.0,23.8,38.1,"Butler County, Ohio",39017,23.53718048632505,21.170935566376727,39017,879.0,8.0
539,0500000US41017,"Deschutes County, Oregon",191996,95592,96404,39129,20104,19025,53680,25573,28107,43.2,99.2,68.2,34.0,34.3,"Deschutes County, Oregon",41017,20.38011208566845,27.958915810746056,41017,308.0,2.0
540,0500000US42033,"Clearfield County, Pennsylvania",79388,41645,37743,14681,7778,6903,21719,10130,11589,45.2,110.3,63.9,33.6,30.3,"Clearfield County, Pennsylvania",42033,18.49271930266539,27.358038998337282,42033,310.0,2.0
541,0500000US45057,"Lancaster County, South Carolina",95380,45837,49543,21139,10366,10773,25563,11121,14442,41.9,92.5,74.7,36.0,38.7,"Lancaster County, South Carolina",45057,22.162927238414763,26.801216187880062,45057,211.0,1.0
542,0500000US47009,"Blount County, Tennessee",131349,63586,67763,27124,14538,12586,36722,16827,19895,43.7,93.8,70.5,35.3,35.2,"Blount County, Tennessee",47009,20.65032851411126,27.957578664474035,47009,471.0,2.0
543,0500000US48121,"Denton County, Texas",859064,422997,436067,211996,108391,103605,128830,60476,68354,35.8,97.0,53.4,15.6,37.9,"Denton County, Texas",48121,24.677556037734092,14.996554389428493,48121,1576.0,19.0
544,0500000US48375,"Potter County, Texas",119648,61240,58408,32795,16553,16242,19834,9105,10729,34.0,104.8,63.4,18.6,44.8,"Potter County, Texas",48375,27.409568066327893,16.576959079967907,48375,1146.0,8.0
545,0500000US48453,"Travis County, Texas",1248743,630777,617966,270535,137636,132899,183401,86805,96596,34.5,102.1,46.1,14.4,31.6,"Travis County, Texas",48453,21.66458590758867,14.686849095450386,48453,3904.0,27.0
546,0500000US49011,"Davis County, Utah",351713,177411,174302,112973,58498,54475,52096,24193,27903,31.4,101.8,73.2,17.6,55.6,"Davis County, Utah",49011,32.12079166820675,14.812076892238842,49011,579.0,4.0
547,0500000US51013,"Arlington County, Virginia",237521,119798,117723,43013,22846,20167,37048,17253,19795,34.7,101.8,40.0,14.6,25.4,"Arlington County, Virginia",51013,18.10913561327209,15.597778722723465,51013,334.0,1.0
548,0500000US01101,"Montgomery County, Alabama",225763,106613,119150,52623,26975,25648,47817,20553,27264,37.2,89.5,62.6,24.7,37.9,"Montgomery County, Alabama",01101,23.308956737817976,21.180175670946966,01101,1143.0,6.0
549,0500000US06073,"San Diego County, California",3343364,1682808,1660556,722408,369604,352804,661304,301542,359762,36.1,101.3,55.4,21.8,33.6,"San Diego County, California",06073,21.60721955491535,19.779599229997093,06073,7658.0,34.0
550,0500000US06077,"San Joaquin County, California",752660,374647,378013,204316,104690,99626,138313,63181,75132,34.5,99.1,66.3,21.2,45.2,"San Joaquin County, California",06077,27.14585603061143,18.37655780830654,06077,1280.0,10.0
551,0500000US10001,"Kent County, Delaware",178550,85805,92745,40645,20589,20056,40615,18019,22596,38.1,92.5,65.2,27.6,37.6,"Kent County, Delaware",10001,22.763931671800616,22.747129655558666,10001,288.0,2.0
552,0500000US12111,"St. Lucie County, Florida",321128,155903,165225,63151,31389,31762,97678,45373,52305,45.2,94.4,77.6,42.7,34.9,"St. Lucie County, Florida",12111,19.665367081039335,30.41715453028076,12111,986.0,6.0
553,0500000US13185,"Lowndes County, Georgia",116321,55535,60786,27878,13770,14108,20411,8378,12033,30.8,91.4,57.4,19.7,37.7,"Lowndes County, Georgia",13185,23.966437702564455,17.54713250401905,13185,475.0,3.0
554,0500000US17001,"Adams County, Illinois",65691,32661,33030,14979,7995,6984,17324,8050,9274,41.5,98.9,75.6,35.5,40.0,"Adams County, Illinois",17001,22.80221034844956,26.37195354005876,17001,335.0,1.0
555,0500000US17037,"DeKalb County, Illinois",104143,50903,53240,22273,10875,11398,18950,8764,10186,30.9,95.6,51.9,19.4,32.5,"DeKalb County, Illinois",17037,21.386939112566374,18.196134161681535,17037,191.0,3.0
556,0500000US17199,"Williamson County, Illinois",67056,33990,33066,14897,7691,7206,18284,8865,9419,40.9,102.8,69.3,31.7,37.6,"Williamson County, Illinois",17199,22.215759961822954,27.266762109281796,17199,431.0,3.0
557,0500000US18063,"Hendricks County, Indiana",167009,83439,83570,41779,22004,19775,33911,14357,19554,38.2,99.8,63.2,22.4,40.8,"Hendricks County, Indiana",18063,25.016017100874805,20.304893748241113,18063,287.0,2.0
558,0500000US19155,"Pottawattamie County, Iowa",93533,45715,47818,21687,11310,10377,23144,10517,12627,39.3,95.6,68.8,29.7,39.1,"Pottawattamie County, Iowa",19155,23.186468946788835,24.744207926614138,19155,514.0,2.0
559,0500000US24021,"Frederick County, Maryland",255648,126543,129105,59288,30453,28835,53942,24903,29039,39.1,98.0,60.2,23.1,37.2,"Frederick County, Maryland",24021,23.191262986606585,21.100106396294905,24021,308.0,1.0
560,0500000US24033,"Prince George's County, Maryland",909308,437625,471683,201928,102486,99442,173650,75410,98240,37.4,92.8,55.0,20.6,34.4,"Prince George's County, Maryland",24033,22.20677702164723,19.096939650811386,24033,866.0,7.0
561,0500000US26045,"Eaton County, Michigan",109826,54390,55436,22484,11727,10757,29221,14022,15199,40.8,98.1,63.8,30.2,33.5,"Eaton County, Michigan",26045,20.47238358858558,26.606632309289242,26045,45.0,2.0
562,0500000US26075,"Jackson County, Michigan",158823,81049,77774,33802,17272,16530,39566,18572,20994,41.5,104.2,64.6,29.6,35.0,"Jackson County, Michigan",26075,21.28281168344635,24.912008965955813,26075,389.0,2.0
563,0500000US26121,"Muskegon County, Michigan",173588,87191,86397,40064,20992,19072,41625,19129,22496,39.3,100.9,66.8,28.3,38.5,"Muskegon County, Michigan",26121,23.07993640113372,23.979192110053692,26121,413.0,3.0
564,0500000US26139,"Ottawa County, Michigan",290494,143592,146902,69532,35230,34302,59528,27404,32124,35.2,97.7,63.6,24.5,39.2,"Ottawa County, Michigan",26139,23.93577836375278,20.491989507528555,26139,311.0,3.0
565,0500000US27003,"Anoka County, Minnesota",353813,176777,177036,84398,42735,41663,72491,33960,38531,39.3,99.9,61.1,22.7,38.4,"Anoka County, Minnesota",27003,23.853843697094227,20.48850664051349,27003,546.0,2.0
566,0500000US31055,"Douglas County, Nebraska",566880,279531,287349,145336,74068,71268,105424,46957,58467,34.8,97.3,63.0,21.2,41.8,"Douglas County, Nebraska",31055,25.637877504939315,18.597233982500704,31055,3068.0,17.0
567,0500000US31109,"Lancaster County, Nebraska",317272,159421,157851,72321,36708,35613,61598,28832,32766,34.0,101.0,57.8,21.8,36.0,"Lancaster County, Nebraska",31109,22.79463677853703,19.414886910915556,31109,1354.0,8.0
568,0500000US33005,"Cheshire County, New Hampshire",76493,36924,39569,13635,6663,6972,21503,10096,11407,43.4,93.3,60.2,31.6,28.5,"Cheshire County, New Hampshire",33005,17.82516047220007,28.11106898670467,33005,169.0,1.0
569,0500000US34011,"Cumberland County, New Jersey",150972,77267,73705,35304,17645,17659,31962,14341,17621,38.4,104.8,63.3,25.1,38.2,"Cumberland County, New Jersey",34011,23.384468643192115,21.170813130911693,34011,511.0,3.0
570,0500000US35049,"Santa Fe County, New Mexico",150056,72779,77277,26881,13591,13290,48548,21839,26709,47.8,94.2,73.3,42.2,31.0,"Santa Fe County, New Mexico",35049,17.913978781255,32.353254784880306,35049,258.0,3.0
571,0500000US37051,"Cumberland County, North Carolina",332330,164324,168006,81795,41267,40528,57046,24600,32446,31.5,97.8,58.0,19.1,38.9,"Cumberland County, North Carolina",37051,24.612583877471188,17.16546805885716,37051,666.0,2.0
572,0500000US42075,"Lebanon County, Pennsylvania",141314,69165,72149,32141,16232,15909,37774,17373,20401,41.3,95.9,73.5,34.0,39.5,"Lebanon County, Pennsylvania",42075,22.744384845096736,26.73054332904029,42075,484.0,3.0
573,0500000US47037,"Davidson County, Tennessee",692587,334254,358333,143599,72638,70961,120004,53499,66505,34.5,93.3,49.1,18.2,30.9,"Davidson County, Tennessee",47037,20.733712876505045,17.326920661231007,47037,4489.0,14.0
574,0500000US48113,"Dallas County, Texas",2637772,1301856,1335916,689655,351719,337936,420518,190577,229941,33.5,97.5,58.4,17.0,41.4,"Dallas County, Texas",48113,26.14536055428597,15.942166343414064,48113,9307.0,56.0
575,0500000US48167,"Galveston County, Texas",337890,166749,171141,81756,42305,39451,67414,31574,35840,37.8,97.4,62.9,23.5,39.4,"Galveston County, Texas",48167,24.196040131403713,19.95146349403652,48167,711.0,4.0
576,0500000US51153,"Prince William County, Virginia",468011,233834,234177,127649,65875,61774,68129,31208,36921,35.4,99.9,59.3,15.8,43.4,"Prince William County, Virginia",51153,27.274786276390937,14.557136477561425,51153,243.0,2.0
577,0500000US51199,"York County, Virginia",67846,31895,35951,16156,6828,9328,15497,6679,8818,39.2,88.7,69.0,28.7,40.2,"York County, Virginia",51199,23.812752409869407,22.84143501459187,51199,145.0,1.0
578,0500000US53011,"Clark County, Washington",481857,238961,242896,114789,59503,55286,104536,48442,56094,38.6,98.4,64.7,25.5,39.2,"Clark County, Washington",53011,23.82221281417516,21.694403111296506,53011,580.0,2.0
579,0500000US55117,"Sheboygan County, Wisconsin",115456,59076,56380,25182,13559,11623,28484,13733,14751,40.8,104.8,65.9,29.7,36.2,"Sheboygan County, Wisconsin",55117,21.810906319290467,24.670870288248338,55117,370.0,2.0
580,0500000US56021,"Laramie County, Wyoming",98976,49623,49353,23122,11161,11961,23335,10851,12484,37.9,100.5,65.8,27.1,38.7,"Laramie County, Wyoming",56021,23.36121888134497,23.576422567086972,56021,206.0,1.0
581,0500000US06053,"Monterey County, California",435594,221011,214583,114103,57676,56427,83363,38633,44730,34.7,103.0,66.3,22.7,43.6,"Monterey County, California",06053,26.194805254434172,19.13777508413798,06053,793.0,4.0
582,0500000US08035,"Douglas County, Colorado",342776,171478,171298,88978,46206,42772,59505,27804,31701,39.1,100.1,60.3,18.7,41.6,"Douglas County, Colorado",08035,25.958060074217563,17.359733470254625,08035,440.0,3.0
583,0500000US12031,"Duval County, Florida",950181,459916,490265,214790,109342,105448,189068,83282,105786,36.3,93.8,57.9,22.2,35.7,"Duval County, Florida",12031,22.60516680506135,19.89810362446734,12031,4071.0,15.0
584,0500000US13255,"Spalding County, Georgia",66100,31881,34219,15812,8398,7414,15606,6858,8748,39.8,93.2,72.7,31.4,41.3,"Spalding County, Georgia",13255,23.921331316187594,23.609682299546144,13255,160.0,1.0
585,0500000US18003,"Allen County, Indiana",375351,184016,191335,96408,49962,46446,75650,33277,42373,36.1,96.2,67.3,24.3,43.0,"Allen County, Indiana",18003,25.68475906551468,20.154468750582787,18003,1558.0,11.0
586,0500000US22005,"Ascension Parish, Louisiana",124672,61257,63415,33250,17224,16026,21340,10020,11320,35.8,96.6,61.4,18.4,43.0,"Ascension Parish, Louisiana",22005,26.66998203285421,17.11691478439425,22005,125.0,5.0
587,0500000US26161,"Washtenaw County, Michigan",370963,184270,186693,68935,35388,33547,72194,33159,39035,33.6,98.7,48.2,20.7,27.5,"Washtenaw County, Michigan",26161,18.582715796454092,19.461240069764372,26161,1719.0,5.0
588,0500000US28089,"Madison County, Mississippi",105630,50119,55511,26401,13260,13141,20435,8722,11713,37.3,90.3,61.3,21.0,40.3,"Madison County, Mississippi",28089,24.993846445138693,19.345829783205527,28089,134.0,2.0
589,0500000US29021,"Buchanan County, Missouri",88571,45106,43465,19704,10299,9405,21405,9642,11763,39.2,103.8,64.5,27.9,36.6,"Buchanan County, Missouri",29021,22.246559257544796,24.167052421221396,29021,393.0,2.0
590,0500000US29077,"Greene County, Missouri",291923,140932,150991,60958,30028,30930,65099,28409,36690,36.6,93.3,59.8,26.5,33.4,"Greene County, Missouri",29077,20.881533829126173,22.300058577090535,29077,1402.0,9.0
591,0500000US34015,"Gloucester County, New Jersey",291408,140687,150721,63477,31451,32026,67035,29733,37302,40.8,93.3,60.7,25.7,35.0,"Gloucester County, New Jersey",34015,21.782861143139513,23.003829682095205,34015,609.0,3.0
592,0500000US34029,"Ocean County, New Jersey",601651,290185,311466,143989,73477,70512,178047,78040,100007,42.7,93.2,87.2,42.4,44.8,"Ocean County, New Jersey",34029,23.93231291895135,29.59306973644189,34029,1522.0,9.0
593,0500000US34039,"Union County, New Jersey",558067,272272,285795,130521,66201,64320,113774,49474,64300,38.8,95.3,60.7,23.1,37.6,"Union County, New Jersey",34039,23.388051972254228,20.387157814384295,34039,1521.0,9.0
594,0500000US36009,"Cattaraugus County, New York",76840,38067,38773,16725,8573,8152,20540,9599,10941,42.4,98.2,69.0,32.2,36.8,"Cattaraugus County, New York",36009,21.7660072878709,26.730869338886,36009,248.0,2.0
595,0500000US36055,"Monroe County, New York",742474,358147,384327,154216,78621,75595,182693,82049,100644,39.2,93.2,61.4,27.8,33.5,"Monroe County, New York",36055,20.77055896906828,24.605979468641326,36055,2009.0,6.0
596,0500000US36109,"Tompkins County, New York",102793,51465,51328,15467,9209,6258,21448,9733,11715,30.8,100.3,40.6,19.4,21.2,"Tompkins County, New York",36109,15.046744428122539,20.86523401398928,36109,212.0,1.0
597,0500000US37027,"Caldwell County, North Carolina",82029,41480,40549,16489,8777,7712,21856,10197,11659,43.7,102.3,65.7,32.4,33.3,"Caldwell County, North Carolina",37027,20.101427543917396,26.644235575223398,37027,110.0,1.0
598,0500000US37063,"Durham County, North Carolina",316739,151423,165316,65685,33231,32454,59884,25493,34391,35.6,91.6,51.4,20.0,31.4,"Durham County, North Carolina",37063,20.737894607231823,18.906418218154382,37063,1360.0,4.0
599,0500000US37191,"Wayne County, North Carolina",123248,60885,62363,29155,15701,13454,30493,13223,17270,38.5,97.6,67.5,27.9,39.6,"Wayne County, North Carolina",37191,23.655556276775282,24.74117227054394,37191,316.0,1.0
600,0500000US41003,"Benton County, Oregon",92101,46488,45613,14770,7870,6900,19806,9149,10657,33.2,101.9,47.4,23.8,23.6,"Benton County, Oregon",41003,16.036742272070878,21.504652501058622,41003,164.0,1.0
601,0500000US41067,"Washington County, Oregon",597695,296224,301471,136616,69942,66674,114869,51429,63440,36.9,98.3,57.0,21.1,35.9,"Washington County, Oregon",41067,22.857142857142858,19.218665038188373,41067,869.0,4.0
602,0500000US42025,"Carbon County, Pennsylvania",64227,31550,32677,12232,5962,6270,18763,9062,9701,46.9,96.6,66.3,34.7,31.7,"Carbon County, Pennsylvania",42025,19.044949943170316,29.213570616718826,42025,155.0,2.0
603,0500000US42069,"Lackawanna County, Pennsylvania",210793,101590,109203,43178,21653,21525,58289,26051,32238,42.1,93.0,67.6,33.3,34.3,"Lackawanna County, Pennsylvania",42069,20.483602396664025,27.652246516724936,42069,1104.0,6.0
604,0500000US45003,"Aiken County, South Carolina",169401,83093,86308,36664,20051,16613,43948,20272,23676,41.3,96.3,69.4,32.7,36.7,"Aiken County, South Carolina",45003,21.643319697050195,25.943176250435357,45003,245.0,1.0
605,0500000US48213,"Henderson County, Texas",82299,38865,43434,17675,8035,9640,25039,12017,13022,43.1,89.5,77.0,39.0,38.0,"Henderson County, Texas",48213,21.476567151484222,30.42442800034022,48213,117.0,1.0
606,0500000US49035,"Salt Lake County, Utah",1152633,577402,575231,312887,158559,154328,181422,83921,97501,32.9,100.4,61.4,17.6,43.8,"Salt Lake County, Utah",49035,27.145414021635684,15.739788813958997,49035,2932.0,18.0
607,0500000US51177,"Spotsylvania County, Virginia",134238,66295,67943,33189,17576,15613,27068,11773,15295,37.4,97.6,64.0,23.5,40.6,"Spotsylvania County, Virginia",51177,24.7239976757699,20.164185998003546,51177,100.0,1.0
608,0500000US01051,"Elmore County, Alabama",81887,39988,41899,18562,9954,8608,17560,8179,9381,38.4,95.4,60.5,24.1,36.4,"Elmore County, Alabama",01051,22.667822731324875,21.444185279714727,01051,138.0,2.0
609,0500000US01115,"St. Clair County, Alabama",88690,44933,43757,20437,11113,9324,20348,9041,11307,40.4,102.7,65.8,27.6,38.2,"St. Clair County, Alabama",01115,23.043184124478522,22.942834592400494,01115,40.0,1.0
610,0500000US05131,"Sebastian County, Arkansas",127753,63266,64487,30526,15807,14719,27059,12395,14664,38.6,98.1,65.8,26.2,39.6,"Sebastian County, Arkansas",05131,23.894546507714104,21.18071591273786,05131,1050.0,7.0
611,0500000US06055,"Napa County, California",139417,69694,69723,28904,15802,13102,36088,16536,19552,41.1,100.0,66.6,32.0,34.5,"Napa County, California",06055,20.73204845893973,25.884935122689484,06055,1780.0,3.0
612,0500000US08059,"Jefferson County, Colorado",580233,288616,291617,114518,58260,56258,137126,62585,74541,40.3,99.0,56.7,25.8,30.9,"Jefferson County, Colorado",08059,19.73655410843575,23.632919878738367,08059,764.0,3.0
613,0500000US12001,"Alachua County, Florida",269956,131429,138527,48712,25484,23228,51494,22699,28795,31.7,94.9,47.1,20.6,26.5,"Alachua County, Florida",12001,18.044422053964347,19.074960363911156,12001,1765.0,6.0
614,0500000US12069,"Lake County, Florida",356495,171434,185061,68110,34065,34045,120848,55608,65240,47.3,92.6,84.5,49.2,35.2,"Lake County, Florida",12069,19.105457299541367,33.89893266385223,12069,943.0,6.0
615,0500000US12127,"Volusia County, Florida",547538,267254,280284,96391,49708,46683,174806,80338,94468,46.6,95.4,72.5,42.1,30.4,"Volusia County, Florida",12127,17.60444023976418,31.92582067363361,12127,2042.0,9.0
616,0500000US17119,"Madison County, Illinois",264461,129143,135318,57464,29979,27485,63613,28726,34887,40.1,95.4,64.0,28.4,35.6,"Madison County, Illinois",17119,21.728723705952863,24.05383024340073,17119,968.0,5.0
617,0500000US18105,"Monroe County, Indiana",146917,72119,74798,22965,11377,11588,27171,11798,15373,29.4,96.4,40.0,18.2,21.9,"Monroe County, Indiana",18105,15.631274801418488,18.494115725205386,18105,368.0,2.0
618,0500000US19169,"Story County, Iowa",98105,50223,47882,16321,8115,8206,15440,6808,8632,26.4,104.9,39.7,16.5,23.2,"Story County, Iowa",19169,16.63625707150502,15.738239641200755,19169,279.0,4.0
619,0500000US34027,"Morris County, New Jersey",494228,241619,252609,104082,52363,51719,119259,53821,65438,42.7,95.6,61.6,27.6,34.0,"Morris County, New Jersey",34027,21.059510994925418,24.13036088606878,34027,2005.0,9.0
620,0500000US36065,"Oneida County, New York",229577,113987,115590,48649,24475,24174,59674,26256,33418,41.0,98.6,65.9,30.8,35.2,"Oneida County, New York",36065,21.19071161309713,25.99302194906284,36065,725.0,4.0
621,0500000US36075,"Oswego County, New York",117898,59222,58676,24424,12236,12188,26939,12857,14082,39.4,100.9,59.3,26.3,33.0,"Oswego County, New York",36075,20.716212319123308,22.849412203769358,36075,158.0,2.0
622,0500000US37147,"Pitt County, North Carolina",179914,83813,96101,38427,19695,18732,34346,14261,20085,32.2,87.2,52.5,20.0,32.6,"Pitt County, North Carolina",37147,21.358537968140332,19.090231999733206,37147,909.0,1.0
623,0500000US39101,"Marion County, Ohio",65256,34660,30596,13958,7103,6855,15891,7339,8552,41.3,113.3,63.6,28.6,35.0,"Marion County, Ohio",39101,21.389604021086186,24.35178374402354,39101,270.0,1.0
624,0500000US39173,"Wood County, Ohio",130696,64457,66239,26382,13264,13118,28712,13104,15608,35.2,97.3,55.1,23.8,31.3,"Wood County, Ohio",39173,20.18577462202363,21.968537675215767,39173,196.0,1.0
625,0500000US41071,"Yamhill County, Oregon",107002,52963,54039,23716,11784,11932,25064,11437,13627,38.5,98.0,63.5,27.2,36.2,"Yamhill County, Oregon",41071,22.164071699594402,23.423861236238576,41071,128.0,2.0
626,0500000US42011,"Berks County, Pennsylvania",420152,205971,214181,93630,47011,46619,98856,45405,53451,40.2,96.2,65.3,28.4,36.8,"Berks County, Pennsylvania",42011,22.284792170452597,23.528627734724576,42011,1247.0,6.0
627,0500000US47155,"Sevier County, Tennessee",97892,48788,49104,20174,11164,9010,25549,11803,13746,43.0,99.4,67.2,32.7,34.5,"Sevier County, Tennessee",47155,20.608425611898827,26.09917051444449,47155,79.0,1.0
628,0500000US48099,"Coryell County, Texas",74808,37030,37778,17218,8566,8652,10442,4394,6048,32.9,98.0,48.8,14.5,34.2,"Coryell County, Texas",48099,23.01625494599508,13.958400171104696,48099,25.0,1.0
629,0500000US48367,"Parker County, Texas",138371,68668,69703,34227,17382,16845,29841,13855,15986,39.5,98.5,67.1,25.8,41.3,"Parker County, Texas",48367,24.73567438263798,21.565935058646684,48367,125.0,2.0
630,0500000US51121,"Montgomery County, Virginia",98985,51636,47349,14304,7369,6935,16914,7500,9414,28.4,109.1,36.5,16.7,19.7,"Montgomery County, Virginia",51121,14.450674344597667,17.087437490528867,51121,280.0,2.0
631,0500000US53029,"Island County, Washington",84460,42186,42274,14684,7431,7253,27451,12214,15237,44.2,99.8,72.5,42.5,30.0,"Island County, Washington",53029,17.38574473123372,32.501775988633675,53029,76.0,2.0
632,0500000US55027,"Dodge County, Wisconsin",87847,45847,42000,17381,8743,8638,22306,10753,11553,43.0,109.2,60.0,28.4,31.7,"Dodge County, Wisconsin",55027,19.785536216376197,25.391874509089668,55027,245.0,3.0
633,0500000US55039,"Fond du Lac County, Wisconsin",103066,50550,52516,22030,11246,10784,26627,12381,14246,41.3,96.3,66.2,30.7,35.5,"Fond du Lac County, Wisconsin",55039,21.374653134884444,25.834901907515572,55039,214.0,4.0
634,0500000US12071,"Lee County, Florida",754610,369892,384718,132674,68338,64336,268785,127356,141429,48.8,96.1,86.0,53.3,32.7,"Lee County, Florida",12071,17.581797219755902,35.619061501967906,12071,2240.0,7.0
635,0500000US12105,"Polk County, Florida",708009,347083,360926,156486,80339,76147,185701,86641,99060,40.2,96.2,73.5,35.1,38.3,"Polk County, Florida",12105,22.102261411931202,26.22862138758123,12105,1793.0,6.0
636,0500000US17019,"Champaign County, Illinois",209983,105260,104723,39285,20623,18662,38656,17697,20959,30.3,100.5,45.4,18.2,27.2,"Champaign County, Illinois",17019,18.70865736750118,18.409109308848812,17019,549.0,3.0
638,0500000US26073,"Isabella County, Michigan",70562,34312,36250,11806,5693,6113,13115,5899,7216,29.0,94.7,42.1,18.3,23.8,"Isabella County, Michigan",26073,16.73138516481959,18.586491312604515,26073,118.0,1.0
639,0500000US28035,"Forrest County, Mississippi",75036,36931,38105,17556,10093,7463,15053,6753,8300,33.1,96.9,59.3,22.0,37.3,"Forrest County, Mississippi",28035,23.396769550615705,20.061037368729675,28035,545.0,2.0
640,0500000US34003,"Bergen County, New Jersey",936692,454629,482063,198333,101181,97152,221840,97877,123963,42.0,94.3,62.2,27.9,34.4,"Bergen County, New Jersey",34003,21.173768965679223,23.68334521913286,34003,3019.0,10.0
641,0500000US34041,"Warren County, New Jersey",105779,52001,53778,20785,10726,10059,27700,12476,15224,44.8,96.7,60.8,29.2,31.6,"Warren County, New Jersey",34041,19.649457831894797,26.186672212821072,34041,309.0,2.0
642,0500000US39003,"Allen County, Ohio",102663,52122,50541,23083,12045,11038,25327,12074,13253,40.0,103.1,66.5,29.1,37.4,"Allen County, Ohio",39003,22.484244567176102,24.670036916902877,39003,830.0,5.0
643,0500000US39043,"Erie County, Ohio",74615,36773,37842,15144,8088,7056,21330,9208,12122,44.8,97.2,72.3,37.3,35.0,"Erie County, Ohio",39043,20.296187093747907,28.586745292501508,39043,424.0,2.0
644,0500000US40145,"Wagoner County, Oklahoma",80110,39632,40478,19503,10049,9454,18293,8454,9839,39.3,97.9,68.2,27.2,40.9,"Wagoner County, Oklahoma",40145,24.345275246536012,22.834852078392213,40145,100.0,1.0
645,0500000US41053,"Polk County, Oregon",85234,40945,44289,19235,9407,9828,20099,9195,10904,37.4,92.4,68.1,30.2,37.9,"Polk County, Oregon",41053,22.567285355609265,23.580965342468968,41053,15.0,1.0
646,0500000US42043,"Dauphin County, Pennsylvania",277097,134626,142471,62354,32085,30269,66024,28518,37506,40.0,94.5,65.0,27.9,37.1,"Dauphin County, Pennsylvania",42043,22.502589345969103,23.827035298108605,42043,1189.0,4.0
647,0500000US42089,"Monroe County, Pennsylvania",169507,83749,85758,33486,17009,16477,43294,20841,22453,42.5,97.7,57.1,26.1,31.0,"Monroe County, Pennsylvania",42089,19.754936374309025,25.54112809500493,42089,235.0,1.0
648,0500000US44005,"Newport County, Rhode Island",82542,41380,41162,13595,7362,6233,25442,12012,13430,45.7,100.5,64.1,37.0,27.0,"Newport County, Rhode Island",44005,16.47040294637881,30.82309612076276,44005,129.0,1.0
649,0500000US44009,"Washington County, Rhode Island",126179,61384,64795,20408,10537,9871,35759,16519,19240,45.0,94.7,58.5,32.9,25.6,"Washington County, Rhode Island",44009,16.17384826318167,28.339898081297203,44009,225.0,2.0
650,0500000US45073,"Oconee County, South Carolina",78374,38805,39569,15586,8136,7450,24791,11085,13706,45.6,98.1,77.5,42.2,35.3,"Oconee County, South Carolina",45073,19.886697118942507,31.63166356189553,45073,169.0,1.0
651,0500000US48187,"Guadalupe County, Texas",163694,81228,82466,41020,21266,19754,30896,14370,16526,37.0,98.5,62.7,22.0,40.8,"Guadalupe County, Texas",48187,25.05895145820861,18.874240961794566,48187,125.0,1.0
652,0500000US48215,"Hidalgo County, Texas",865939,425393,440546,281292,144152,137140,130718,59106,71612,29.5,96.6,77.2,19.6,57.6,"Hidalgo County, Texas",48215,32.48404333330639,15.09552058516824,48215,2386.0,16.0
653,0500000US48329,"Midland County, Texas",172578,86130,86448,49279,24446,24833,27401,12722,14679,31.7,99.6,64.2,17.3,46.9,"Midland County, Texas",48329,28.554624575554243,15.877458308706787,48329,669.0,5.0
654,0500000US53061,"Snohomish County, Washington",814901,407880,407021,184546,93788,90758,162378,74693,87685,37.8,100.2,56.6,21.1,35.5,"Snohomish County, Washington",53061,22.646431897862442,19.926101452814514,53061,786.0,5.0
655,0500000US55079,"Milwaukee County, Wisconsin",948201,459198,489003,227433,115936,111497,189024,83482,105542,35.1,93.9,60.2,21.8,38.4,"Milwaukee County, Wisconsin",55079,23.9857372012896,19.93501377872413,55079,4743.0,21.0
656,0500000US55101,"Racine County, Wisconsin",196584,97477,99107,45350,23413,21937,46771,21496,25275,39.6,98.4,65.4,27.3,38.2,"Racine County, Wisconsin",55101,23.069018841818256,23.791865055141823,55101,715.0,4.0
657,0500000US06047,"Merced County, California",274765,138520,136245,80340,41038,39302,43607,20049,23558,31.4,101.7,67.9,18.8,49.1,"Merced County, California",06047,29.23953196367805,15.870653103561224,06047,246.0,3.0
658,0500000US06081,"San Mateo County, California",769545,381684,387861,158477,81819,76658,172134,77527,94607,39.9,98.4,58.0,25.5,32.5,"San Mateo County, California",06081,20.593597515414952,22.36828255657564,06081,1781.0,10.0
659,0500000US02170,"Matanuska-Susitna Borough, Alaska",107610,55481,52129,28861,14835,14026,20038,9991,10047,35.5,106.4,63.8,19.9,43.9,"Matanuska-Susitna Borough, Alaska",02170,26.819998141436667,18.62094600873525,02170,74.0,1.0
660,0500000US04027,"Yuma County, Arizona",212128,109526,102602,53632,27675,25957,51270,24063,27207,35.1,106.7,79.0,33.7,45.3,"Yuma County, Arizona",04027,25.282848091718208,24.16936943732086,04027,410.0,2.0
661,0500000US05119,"Pulaski County, Arkansas",392680,187585,205095,90988,45565,45423,84878,37385,47493,37.9,91.5,63.2,25.4,37.8,"Pulaski County, Arkansas",05119,23.17102984618519,21.615055515941734,05119,3323.0,16.0
662,0500000US13045,"Carroll County, Georgia",118121,58237,59884,28077,14818,13259,23597,10716,12881,34.9,97.2,61.2,22.9,38.3,"Carroll County, Georgia",13045,23.769693788572734,19.976972765215333,13045,344.0,3.0
663,0500000US13067,"Cobb County, Georgia",756865,366941,389924,178195,89981,88214,134462,60168,74294,36.7,94.1,55.8,19.1,36.7,"Cobb County, Georgia",13067,23.54382882019911,17.76565173445727,13067,1274.0,6.0
664,0500000US13139,"Hall County, Georgia",202148,100325,101823,51279,26185,25094,41323,18990,22333,36.8,98.5,67.4,24.9,42.5,"Hall County, Georgia",13139,25.367057799236203,20.44195342026634,13139,557.0,1.0
665,0500000US18085,"Kosciusko County, Indiana",79344,39626,39718,18892,9966,8926,18917,8860,10057,38.5,99.8,67.4,27.6,39.9,"Kosciusko County, Indiana",18085,23.810244000806613,23.84175236942932,18085,88.0,2.0
666,0500000US18163,"Vanderburgh County, Indiana",180974,88305,92669,39195,21034,18161,43193,19356,23837,38.6,95.3,62.1,27.0,35.1,"Vanderburgh County, Indiana",18163,21.65780719882414,23.86696431531601,18163,1266.0,5.0
667,0500000US22033,"East Baton Rouge Parish, Louisiana",440956,210721,230235,100180,50446,49734,89247,39483,49764,34.2,91.5,58.5,22.5,36.0,"East Baton Rouge Parish, Louisiana",22033,22.718820018323825,20.239434319977505,22033,2733.0,15.0
668,0500000US24013,"Carroll County, Maryland",168429,83560,84869,36578,19089,17489,39623,18225,21398,42.1,98.5,61.4,26.4,35.1,"Carroll County, Maryland",24013,21.717162721384085,23.525046161884237,24013,409.0,2.0
669,0500000US24045,"Wicomico County, Maryland",103195,48745,54450,22715,11714,11001,22059,9790,12269,35.5,89.5,60.7,25.3,35.4,"Wicomico County, Maryland",24045,22.01172537429139,21.376035660642472,24045,416.0,3.0
670,0500000US25027,"Worcester County, Massachusetts",830839,409838,421001,174421,89237,85184,185807,85323,100484,40.0,97.3,57.8,24.7,33.1,"Worcester County, Massachusetts",25027,20.993357317121607,22.363779264093285,25027,2233.0,15.0
671,0500000US26065,"Ingham County, Michigan",292735,142463,150272,58406,29369,29037,57502,25716,31786,32.1,94.8,50.5,20.5,30.0,"Ingham County, Michigan",26065,19.95183356961074,19.64302184569662,26065,1123.0,6.0
672,0500000US34019,"Hunterdon County, New Jersey",124714,62020,62694,24239,12422,11817,32110,15196,16914,46.6,98.9,61.6,30.2,31.4,"Hunterdon County, New Jersey",34019,19.435668810237825,25.74690892762641,34019,184.0,1.0
673,0500000US36063,"Niagara County, New York",210433,102743,107690,42063,21371,20692,58909,26996,31913,43.7,95.4,63.7,31.0,32.7,"Niagara County, New York",36063,19.988785028964088,27.994183421801715,36063,623.0,5.0
674,0500000US36079,"Putnam County, New York",98892,49528,49364,19590,10178,9412,25085,12147,12938,43.7,100.3,59.0,27.5,31.5,"Putnam County, New York",36079,19.809489139667516,25.366055899364966,36079,164.0,1.0
675,0500000US37049,"Craven County, North Carolina",102912,52488,50424,23254,12308,10946,26806,12029,14777,38.4,104.1,71.3,32.6,38.7,"Craven County, North Carolina",37049,22.59600435323383,26.04749689054726,37049,350.0,1.0
676,0500000US37151,"Randolph County, North Carolina",143351,70559,72792,32132,16840,15292,34536,15107,19429,40.7,96.9,66.7,29.3,37.4,"Randolph County, North Carolina",37151,22.414911650424482,24.09191425242935,37151,145.0,1.0
677,0500000US39141,"Ross County, Ohio",76931,40171,36760,16140,8128,8012,18838,8497,10341,41.5,109.3,62.2,28.2,34.0,"Ross County, Ohio",39141,20.979839076575114,24.486877851581287,39141,261.0,1.0
678,0500000US40109,"Oklahoma County, Oklahoma",792582,388210,404372,203376,104278,99098,151828,66958,84870,34.8,96.0,64.8,22.5,42.3,"Oklahoma County, Oklahoma",40109,25.65993171684444,19.156125170644803,40109,4624.0,28.0
679,0500000US48245,"Jefferson County, Texas",255001,130211,124790,61335,30810,30525,52782,23841,28941,36.3,104.3,62.3,23.3,39.0,"Jefferson County, Texas",48245,24.052846851580973,20.69874235787311,48245,1699.0,14.0
680,0500000US48303,"Lubbock County, Texas",307412,151863,155549,73119,37114,36005,54743,23903,30840,31.1,97.6,56.3,19.1,37.2,"Lubbock County, Texas",48303,23.78534344788102,17.807697812707378,48303,1563.0,9.0
681,0500000US54003,"Berkeley County, West Virginia",117123,59048,58075,27231,14474,12757,25551,12416,13135,39.4,101.7,61.9,24.3,37.6,"Berkeley County, West Virginia",54003,23.249916754181502,21.815527266207322,54003,241.0,1.0
682,0500000US55073,"Marathon County, Wisconsin",135428,67784,67644,30847,15295,15552,32791,15482,17309,40.6,100.2,67.6,29.4,38.2,"Marathon County, Wisconsin",55073,22.77741678234929,24.21286587707121,55073,440.0,3.0
683,0500000US02090,"Fairbanks North Star Borough, Alaska",98971,53397,45574,23858,12319,11539,15628,7865,7763,31.7,117.2,52.5,15.7,36.8,"Fairbanks North Star Borough, Alaska",02090,24.10605126754302,15.790484081195503,02090,217.0,1.0
685,0500000US06001,"Alameda County, California",1666753,820179,846574,342511,175317,167194,326369,147022,179347,37.6,96.9,52.4,21.1,31.3,"Alameda County, California",06001,20.549595530951496,19.581125697688858,06001,4046.0,26.0
686,0500000US06097,"Sonoma County, California",499942,243952,255990,98257,49966,48291,134385,61093,73292,42.4,95.3,64.6,32.3,32.4,"Sonoma County, California",06097,19.653679826859914,26.88011809369887,06097,2071.0,11.0
687,0500000US06113,"Yolo County, California",220408,107008,113400,46898,23476,23422,38255,17277,20978,31.1,94.4,50.6,18.6,32.0,"Yolo County, California",06113,21.277812057638563,17.356448041813362,06113,156.0,2.0
688,0500000US09015,"Windham County, Connecticut",117027,56804,60223,22740,10661,12079,27796,12531,15265,41.0,94.3,55.3,25.1,30.2,"Windham County, Connecticut",09015,19.431413263605833,23.75178377639348,09015,234.0,2.0
689,0500000US12011,"Broward County, Florida",1951260,950854,1000406,412226,209392,202834,451231,204080,247151,40.4,95.0,60.7,26.7,33.9,"Broward County, Florida",12011,21.12614413250925,23.125108903990245,12011,6803.0,28.0
690,0500000US20177,"Shawnee County, Kansas",177499,86456,91043,41948,21756,20192,45542,20094,25448,39.3,95.0,72.7,31.9,40.8,"Shawnee County, Kansas",20177,23.632809198925063,25.65760933864416,20177,768.0,4.0
691,0500000US21067,"Fayette County, Kentucky",323780,158158,165622,67494,34595,32899,61241,26358,34883,34.9,95.5,51.8,20.1,31.6,"Fayette County, Kentucky",21067,20.845635925628514,18.914386311693125,21067,2379.0,9.0
692,0500000US22017,"Caddo Parish, Louisiana",242922,114771,128151,57735,29061,28674,57613,25140,32473,38.0,89.6,69.2,29.0,40.2,"Caddo Parish, Louisiana",22017,23.76688813693284,23.716666255011898,22017,2328.0,11.0
693,0500000US22079,"Rapides Parish, Louisiana",130562,63788,66774,32043,16663,15380,29525,13875,15650,37.5,95.5,69.0,27.5,41.5,"Rapides Parish, Louisiana",22079,24.542363015272436,22.61377736247913,22079,966.0,7.0
694,0500000US26147,"St. Clair County, Michigan",159337,79580,79757,33130,17437,15693,42683,20001,22682,44.3,99.8,65.6,31.2,34.4,"St. Clair County, Michigan",26147,20.79240854289964,26.78787726642274,26147,398.0,3.0
695,0500000US27171,"Wright County, Minnesota",136349,69510,66839,37831,20265,17566,24127,11952,12175,37.8,104.0,67.5,21.0,46.5,"Wright County, Minnesota",27171,27.745711373020704,17.69503260016575,27171,104.0,2.0
696,0500000US29095,"Jackson County, Missouri",700307,338175,362132,165105,83623,81482,149279,65552,83727,36.7,93.4,62.7,24.3,38.4,"Jackson County, Missouri",29095,23.576088772495492,21.316222742311584,29095,4101.0,18.0
697,0500000US36051,"Livingston County, New York",63227,32028,31199,11279,5752,5527,15988,7837,8151,42.3,102.7,54.9,27.2,27.6,"Livingston County, New York",36051,17.838897939171556,25.28666550682462,36051,67.0,1.0
698,0500000US36103,"Suffolk County, New York",1481093,729779,751314,313018,159844,153174,350879,159441,191438,41.8,97.1,61.3,27.2,34.1,"Suffolk County, New York",36103,21.134256930523605,23.690544753097882,36103,3583.0,13.0
699,0500000US40027,"Cleveland County, Oklahoma",281669,140148,141521,60611,30668,29943,50924,23315,27609,34.3,99.0,53.3,20.3,33.0,"Cleveland County, Oklahoma",40027,21.518519964923367,18.079376857233136,40027,857.0,6.0
700,0500000US40101,"Muskogee County, Oklahoma",68362,33349,35013,16640,8518,8122,15309,7091,8218,38.4,95.2,69.2,28.0,41.2,"Muskogee County, Oklahoma",40101,24.34100816242942,22.394020069629324,40101,429.0,3.0
701,0500000US41035,"Klamath County, Oregon",67653,33719,33934,14986,7574,7412,20129,9899,10230,41.8,99.4,77.8,38.4,39.4,"Klamath County, Oregon",41035,22.15127193176947,29.75329992757158,41035,98.0,1.0
702,0500000US42101,"Philadelphia County, Pennsylvania",1584138,750017,834121,344091,175208,168883,307503,127833,179670,34.5,89.9,54.7,21.1,33.6,"Philadelphia County, Pennsylvania",42101,21.721024304700727,19.41137703912159,42101,8387.0,32.0
703,0500000US45019,"Charleston County, South Carolina",405905,196418,209487,79975,41090,38885,89296,40045,49251,38.2,93.8,56.2,25.4,30.8,"Charleston County, South Carolina",45019,19.702886143309396,21.999236274497726,45019,2166.0,11.0
704,0500000US45047,"Greenwood County, South Carolina",70741,32504,38237,15422,7208,8214,17252,7428,9824,40.7,85.0,67.1,30.7,36.4,"Greenwood County, South Carolina",45047,21.800653086611725,24.387554600585233,45047,400.0,2.0
705,0500000US47141,"Putnam County, Tennessee",78843,38688,40155,16043,7545,8498,18733,8416,10317,36.8,96.3,59.0,26.6,32.3,"Putnam County, Tennessee",47141,20.348033433532464,23.75987722435727,47141,247.0,1.0
706,0500000US48257,"Kaufman County, Texas",128622,62516,66106,35781,17265,18516,23275,11136,12139,35.2,94.6,65.3,19.3,46.0,"Kaufman County, Texas",48257,27.81872463497691,18.09566015145154,48257,407.0,2.0
707,0500000US48381,"Randall County, Texas",136271,67280,68991,32494,16724,15770,29047,12688,16359,36.1,97.5,63.9,24.8,39.1,"Randall County, Texas",48381,23.845132126424552,21.315613740267555,48381,4.0,1.0
708,0500000US55071,"Manitowoc County, Wisconsin",79074,39951,39123,16065,8438,7627,22378,10253,12125,45.2,102.1,68.0,33.9,34.1,"Manitowoc County, Wisconsin",55071,20.316412474391075,28.30007334901485,55071,236.0,2.0
709,0500000US55139,"Winnebago County, Wisconsin",171020,86310,84710,34900,17477,17423,38325,17362,20963,38.8,101.9,58.2,25.9,32.3,"Winnebago County, Wisconsin",55139,20.40696994503567,22.40965968892527,55139,795.0,5.0
710,0500000US01095,"Marshall County, Alabama",96109,47238,48871,23959,12058,11901,22771,9833,12938,39.0,96.7,72.7,29.6,43.0,"Marshall County, Alabama",01095,24.92898687948059,23.6928903640658,01095,240.0,2.0
711,0500000US04017,"Navajo County, Arizona",110445,55015,55430,29343,14768,14575,27600,12873,14727,38.5,99.3,81.2,33.1,48.2,"Navajo County, Arizona",04017,26.567975010186068,24.98981393453755,04017,130.0,3.0
712,0500000US06107,"Tulare County, California",465861,234322,231539,142990,74287,68703,76689,36059,40630,31.4,101.2,72.4,19.5,52.9,"Tulare County, California",06107,30.69370477460015,16.461777225395558,06107,2086.0,7.0
713,0500000US08077,"Mesa County, Colorado",153207,74894,78313,33709,17029,16680,38857,17983,20874,41.0,95.6,68.9,31.8,37.2,"Mesa County, Colorado",08077,22.002258382449888,25.362418166271777,08077,460.0,2.0
714,0500000US09001,"Fairfield County, Connecticut",943823,459662,484161,211990,108034,103956,213405,96987,116418,40.8,94.9,62.2,25.7,36.4,"Fairfield County, Connecticut",09001,22.460779192708802,22.610701370913826,09001,2066.0,6.0
715,0500000US12089,"Nassau County, Florida",85832,42698,43134,17088,9022,8066,24966,12056,12910,46.1,99.0,71.8,37.6,34.2,"Nassau County, Florida",12089,19.908658775281946,29.087053779476186,12089,54.0,1.0
716,0500000US17163,"St. Clair County, Illinois",261059,126952,134107,61162,32190,28972,60062,26056,34006,39.6,94.7,64.2,25.8,38.5,"St. Clair County, Illinois",17163,23.428420395389548,23.00705970680957,17163,818.0,4.0
717,0500000US18035,"Delaware County, Indiana",114772,55362,59410,21430,11327,10103,26512,11417,15095,35.0,93.2,56.3,27.1,29.2,"Delaware County, Indiana",18035,18.671801484682675,23.099710730840275,18035,411.0,3.0
718,0500000US18091,"LaPorte County, Indiana",110007,58196,51811,23422,13199,10223,26760,12279,14481,40.4,112.3,64.4,29.4,35.0,"LaPorte County, Indiana",18091,21.291372367212997,24.325724726608307,18091,377.0,2.0
719,0500000US18095,"Madison County, Indiana",129641,64211,65430,28037,13936,14101,32428,14598,17830,40.2,98.1,66.3,30.3,36.0,"Madison County, Indiana",18095,21.6266458913461,25.013691656189014,18095,402.0,5.0
720,0500000US21117,"Kenton County, Kentucky",166051,81777,84274,39370,19996,19374,34304,15223,19081,36.2,97.0,61.8,23.4,38.4,"Kenton County, Kentucky",21117,23.709583200342063,20.658713286881742,21117,728.0,4.0
721,0500000US22055,"Lafayette Parish, Louisiana",242782,117790,124992,57348,28955,28393,45018,20187,24831,35.4,94.2,58.1,20.7,37.3,"Lafayette Parish, Louisiana",22055,23.6211910273414,18.542560815875973,22055,1120.0,13.0
722,0500000US24017,"Charles County, Maryland",161503,77505,83998,38138,19326,18812,30961,13939,17022,38.2,92.3,56.1,19.3,36.9,"Charles County, Maryland",24017,23.614422023120312,19.17054172368315,24017,89.0,1.0
723,0500000US26077,"Kalamazoo County, Michigan",264870,130970,133900,57284,30254,27030,55603,24699,30904,34.5,97.8,57.9,23.7,34.1,"Kalamazoo County, Michigan",26077,21.627213349945258,20.992562389096538,26077,821.0,2.0
724,0500000US27109,"Olmsted County, Minnesota",156277,76519,79758,38257,19587,18670,32853,14825,18028,38.1,95.9,66.7,25.9,40.8,"Olmsted County, Minnesota",27109,24.48024981283234,21.022287348746136,27109,2120.0,3.0
725,0500000US27141,"Sherburne County, Minnesota",96036,49471,46565,25172,12536,12636,14992,7292,7700,35.6,106.2,59.3,17.6,41.8,"Sherburne County, Minnesota",27141,26.2110042067558,15.610812611937192,27141,54.0,1.0
726,0500000US34009,"Cape May County, New Jersey",92560,45935,46625,14739,7818,6921,32273,14797,17476,50.4,98.5,72.2,44.8,27.4,"Cape May County, New Jersey",34009,15.92372515125324,34.867113223854794,34009,242.0,1.0
727,0500000US35045,"San Juan County, New Mexico",125043,61679,63364,32938,16295,16643,26624,12711,13913,36.0,97.3,71.3,26.2,45.1,"San Juan County, New Mexico",35045,26.341338579528646,21.29187559479539,35045,267.0,3.0
728,0500000US36089,"St. Lawrence County, New York",108047,55626,52421,21600,11232,10368,25695,12100,13595,39.8,106.1,58.9,27.2,31.8,"St. Lawrence County, New York",36089,19.99130008237156,23.781317389654504,36089,319.0,5.0
729,0500000US37081,"Guilford County, North Carolina",533670,252785,280885,119037,60334,58703,113925,50112,63813,37.0,90.0,59.7,24.1,35.6,"Guilford County, North Carolina",37081,22.305357243240202,21.347461914666365,37081,1833.0,7.0
730,0500000US39095,"Lucas County, Ohio",429899,208451,221448,98562,50698,47864,98624,43134,55490,38.1,94.1,64.6,26.9,37.7,"Lucas County, Ohio",39095,22.926780476344444,22.941202468486786,39095,3357.0,12.0
731,0500000US40143,"Tulsa County, Oklahoma",648360,316400,331960,164041,83998,80043,131100,57987,73113,35.9,95.3,65.8,23.9,42.0,"Tulsa County, Oklahoma",40143,25.300913072984144,20.22024801036461,40143,3832.0,23.0
732,0500000US44003,"Kent County, Rhode Island",163861,80021,83840,30876,16645,14231,44632,20040,24592,44.0,95.4,60.5,30.3,30.3,"Kent County, Rhode Island",44003,18.842799689981142,27.23771977468708,44003,359.0,1.0
733,0500000US48039,"Brazoria County, Texas",370200,187017,183183,97974,50344,47630,62577,29709,32868,36.1,102.1,62.0,19.1,42.9,"Brazoria County, Texas",48039,26.465153970826584,16.90356564019449,48039,357.0,5.0
734,0500000US48491,"Williamson County, Texas",566719,278884,287835,145367,74518,70849,96359,43734,52625,36.5,96.9,60.7,19.5,41.2,"Williamson County, Texas",48491,25.65063108877592,17.002959138479564,48491,1009.0,12.0
735,0500000US53045,"Mason County, Washington",65507,33563,31944,12538,6073,6465,19559,9137,10422,45.7,105.1,71.9,39.0,32.9,"Mason County, Washington",53045,19.13993924313432,29.85787778405361,53045,25.0,1.0
736,0500000US55105,"Rock County, Wisconsin",163129,80917,82212,37426,20050,17376,37580,16542,21038,39.4,98.4,65.5,27.5,38.0,"Rock County, Wisconsin",55105,22.942579185797744,23.036983001183113,55105,564.0,4.0
737,0500000US06057,"Nevada County, California",99696,48808,50888,17079,8779,8300,36584,17132,19452,50.5,95.9,81.7,50.6,31.1,"Nevada County, California",06057,17.131078478574867,36.695554485636336,06057,176.0,2.0
738,0500000US12019,"Clay County, Florida",216072,108064,108008,50354,27182,23172,47841,22591,25250,39.6,100.1,65.0,26.5,38.4,"Clay County, Florida",12019,23.304268947387907,22.141230700877486,12019,416.0,3.0
739,0500000US12055,"Highlands County, Florida",105424,50863,54561,18396,8674,9722,45206,21540,23666,53.2,93.2,111.8,74.8,37.0,"Highlands County, Florida",12055,17.449537107300046,42.880179086356044,12055,323.0,3.0
740,0500000US12131,"Walton County, Florida",71375,34634,36741,14377,6821,7556,19921,9495,10426,44.4,94.3,68.0,34.2,33.8,"Walton County, Florida",12131,20.14290718038529,27.910332749562173,12131,108.0,2.0
741,0500000US15009,"Maui County, Hawaii",167218,82282,84936,36038,17054,18984,42244,19991,22253,41.1,96.9,66.1,30.3,35.8,"Maui County, Hawaii",15009,21.551507612816803,25.262830556519035,15009,258.0,4.0
742,0500000US23005,"Cumberland County, Maine",293557,142838,150719,54503,28526,25977,74565,34046,40519,42.1,94.8,58.6,29.2,29.4,"Cumberland County, Maine",23005,18.56641129320711,25.400518468304284,23005,1269.0,8.0
743,0500000US33015,"Rockingham County, New Hampshire",309176,152965,156211,60249,30757,29492,79192,37063,42129,44.8,97.9,59.8,28.6,31.1,"Rockingham County, New Hampshire",33015,19.486958884260098,25.613889823272178,33015,606.0,6.0
744,0500000US35031,"McKinley County, New Mexico",72290,34525,37765,20836,10609,10227,14676,5826,8850,32.3,91.4,71.4,22.0,49.4,"McKinley County, New Mexico",35031,28.822797067367546,20.301563148429935,35031,228.0,4.0
745,0500000US36011,"Cayuga County, New York",77145,39764,37381,15264,7945,7319,19699,9441,10258,42.4,106.4,62.2,30.1,32.1,"Cayuga County, New York",36011,19.786117052304103,25.53503143431201,36011,99.0,1.0
746,0500000US36047,"Kings County, New York",2582830,1223278,1359552,588823,300639,288184,499818,208386,291432,35.4,90.0,58.0,21.9,36.0,"Kings County, New York",36047,22.797590240162922,19.35156398214362,36047,6166.0,15.0
747,0500000US37089,"Henderson County, North Carolina",116748,56330,60418,22053,12135,9918,38616,17076,21540,48.3,93.2,81.4,47.1,34.3,"Henderson County, North Carolina",37089,18.889402816322335,33.07636961661014,37089,325.0,2.0
748,0500000US39057,"Greene County, Ohio",167995,82995,85000,34891,17898,16993,40333,18202,22131,37.9,97.6,61.5,27.9,33.5,"Greene County, Ohio",39057,20.769070508050834,24.008452632518825,39057,176.0,2.0
749,0500000US39139,"Richland County, Ohio",121099,60963,60136,25845,12885,12960,31379,13925,17454,41.5,101.4,69.3,33.2,36.1,"Richland County, Ohio",39139,21.342042461126848,25.911857240769947,39139,431.0,3.0
750,0500000US41033,"Josephine County, Oregon",87393,43294,44099,16840,9050,7790,29992,13976,16016,47.9,98.2,83.3,47.9,35.3,"Josephine County, Oregon",41033,19.26927785978282,34.318538098017,41033,125.0,1.0
751,0500000US42007,"Beaver County, Pennsylvania",164742,80056,84686,31834,15811,16023,47638,21811,25827,45.6,94.5,69.3,36.6,32.7,"Beaver County, Pennsylvania",42007,19.32354833618628,28.916730402690266,42007,396.0,2.0
752,0500000US42037,"Columbia County, Pennsylvania",65456,31765,33691,11380,5916,5464,17477,8052,9425,41.0,94.3,58.2,30.7,27.5,"Columbia County, Pennsylvania",42037,17.385724761671963,26.700378880469323,42037,173.0,2.0
753,0500000US45031,"Darlington County, South Carolina",66802,33149,33653,14925,8970,5955,18369,8005,10364,41.1,98.5,70.3,32.2,38.0,"Darlington County, South Carolina",45031,22.342145444747164,27.497679710188315,45031,188.0,2.0
754,0500000US45079,"Richland County, South Carolina",414576,200692,213884,88465,44950,43515,75445,32236,43209,33.5,93.8,51.7,19.4,32.4,"Richland County, South Carolina",45079,21.33866890509822,18.19811084095558,45079,2585.0,14.0
755,0500000US48157,"Fort Bend County, Texas",787858,386679,401179,215824,109905,105919,130727,61206,69521,36.6,96.4,62.5,18.0,44.5,"Fort Bend County, Texas",48157,27.39376892790325,16.59271086921755,48157,1105.0,12.0
756,0500000US48181,"Grayson County, Texas",133991,65122,68869,31346,16283,15063,31365,13877,17488,40.1,94.6,69.5,29.9,39.7,"Grayson County, Texas",48181,23.394108559530117,23.40828861639961,48181,602.0,8.0
757,0500000US48451,"Tom Green County, Texas",118189,59451,58738,28181,14685,13496,24528,11377,13151,33.9,101.2,63.9,24.8,39.1,"Tom Green County, Texas",48451,23.84401255616005,20.753200382438298,48451,614.0,4.0
759,0500000US53021,"Franklin County, Washington",94347,48874,45473,30919,15495,15424,13455,7055,6400,30.3,107.5,73.9,16.9,57.0,"Franklin County, Washington",53021,32.771577262658056,14.26118477535057,53021,106.0,1.0
760,0500000US53025,"Grant County, Washington",97331,49789,47542,28290,14311,13979,19409,9805,9604,33.4,104.7,77.1,25.6,51.5,"Grant County, Washington",53025,29.065765275194956,19.941231467877653,53025,186.0,4.0
761,0500000US55109,"St. Croix County, Wisconsin",89694,44329,45365,22503,11252,11251,17626,8583,9043,39.7,97.7,64.0,22.8,41.1,"St. Croix County, Wisconsin",55109,25.088634691283694,19.65125872410641,55109,125.0,5.0
762,0500000US05045,"Faulkner County, Arkansas",124806,60576,64230,28872,14431,14441,22799,10292,12507,32.9,94.3,55.6,19.6,36.0,"Faulkner County, Arkansas",05045,23.133503196961687,18.26755123952374,05045,172.0,2.0
763,0500000US06019,"Fresno County, California",994400,495950,498450,281820,143722,138098,169961,78005,91956,32.5,99.5,68.2,20.6,47.7,"Fresno County, California",06019,28.34070796460177,17.091814159292035,06019,3551.0,14.0
764,0500000US08013,"Boulder County, Colorado",326078,163621,162457,62140,31129,31011,67916,30982,36934,36.6,100.7,49.6,21.1,28.5,"Boulder County, Colorado",08013,19.05679009316789,20.82814541306068,08013,700.0,5.0
765,0500000US08041,"El Paso County, Colorado",713856,360752,353104,172062,87699,84363,130886,59380,71506,34.3,102.2,58.5,20.3,38.2,"El Paso County, Colorado",08041,24.10318047337278,18.33507037833961,08041,1511.0,9.0
766,0500000US12015,"Charlotte County, Florida",184998,90140,94858,22207,11725,10482,91878,43934,47944,59.8,95.0,109.1,84.0,25.1,"Charlotte County, Florida",12015,12.003913555822225,49.664320695358875,12015,823.0,4.0
767,0500000US12057,"Hillsborough County, Florida",1436888,702808,734080,323828,166145,157683,287770,127429,160341,37.1,95.7,58.4,22.7,35.7,"Hillsborough County, Florida",12057,22.536759997995667,20.02730901782185,12057,4857.0,18.0
768,0500000US18043,"Floyd County, Indiana",77781,37644,40137,17558,8591,8967,17513,7784,9729,39.5,93.8,62.8,26.0,36.7,"Floyd County, Indiana",18043,22.57363623507026,22.515781489052596,18043,297.0,3.0
769,0500000US21093,"Hardin County, Kentucky",110356,55818,54538,27112,14609,12503,23125,10232,12893,36.6,102.3,63.7,23.5,40.2,"Hardin County, Kentucky",21093,24.56776251404545,20.954909565406503,21093,465.0,3.0
770,0500000US22071,"Orleans Parish, Louisiana",391006,185255,205751,78124,39548,38576,82084,35863,46221,37.3,90.0,53.1,22.5,30.6,"Orleans Parish, Louisiana",22071,19.980256057451804,20.993028239975857,22071,1671.0,10.0
771,0500000US23003,"Aroostook County, Maine",67111,32867,34244,12567,6237,6330,22370,10632,11738,48.5,96.0,75.0,42.2,32.8,"Aroostook County, Maine",23003,18.72569325445903,33.33283664376928,23003,256.0,6.0
772,0500000US24005,"Baltimore County, Maryland",828431,392736,435695,178822,91088,87734,199558,86886,112672,39.5,90.1,63.4,28.1,35.3,"Baltimore County, Maryland",24005,21.58562390832791,24.088668820939823,24005,1899.0,6.0
773,0500000US24043,"Washington County, Maryland",150926,77920,73006,32970,18026,14944,37207,16807,20400,39.6,106.7,64.2,28.4,35.9,"Washington County, Maryland",24043,21.845142652690722,24.652478698169965,24043,372.0,3.0
774,0500000US26125,"Oakland County, Michigan",1259201,616837,642364,264031,134892,129139,300804,133784,167020,40.8,96.0,60.7,27.0,33.7,"Oakland County, Michigan",26125,20.968137731783884,23.888481664166402,26125,4435.0,17.0
775,0500000US34001,"Atlantic County, New Jersey",265429,129633,135796,56422,29683,26739,65593,29138,36455,41.9,95.5,64.4,29.5,34.9,"Atlantic County, New Jersey",34001,21.25690862716583,24.71206989439737,34001,1573.0,9.0
776,0500000US34023,"Middlesex County, New Jersey",829685,409784,419901,179932,91974,87958,174848,78948,95900,38.7,97.6,57.9,23.6,34.2,"Middlesex County, New Jersey",34023,21.686784743607515,21.0740220686164,34023,2782.0,11.0
777,0500000US34037,"Sussex County, New Jersey",140799,70186,70613,28019,14527,13492,35601,17404,18197,44.6,99.4,58.0,26.6,31.4,"Sussex County, New Jersey",34037,19.899999289767685,25.284980717192596,34037,146.0,1.0
778,0500000US35005,"Chaves County, New Mexico",64689,32254,32435,16484,8770,7714,15317,7198,8119,36.9,99.4,73.1,29.0,44.1,"Chaves County, New Mexico",35005,25.48192119216559,23.67790505340939,35005,229.0,3.0
779,0500000US35013,"Doña Ana County, New Mexico",217522,106963,110559,52231,26272,25959,46611,22093,24518,33.6,96.7,66.7,26.7,40.0,"Doña Ana County, New Mexico",35013,24.011824091356278,21.42817737975929,35013,603.0,6.0
780,0500000US36085,"Richmond County, New York",476179,230765,245414,104037,53302,50735,110711,49137,61574,40.1,94.0,61.4,26.1,35.3,"Richmond County, New York",36085,21.84829654394671,23.24987032187476,36085,1187.0,4.0
781,0500000US42071,"Lancaster County, Pennsylvania",543557,265726,277831,127711,65164,62547,133044,60316,72728,38.7,95.6,71.4,31.1,40.3,"Lancaster County, Pennsylvania",42071,23.495419983552782,24.47654983745955,42071,1191.0,5.0
782,0500000US42107,"Schuylkill County, Pennsylvania",142067,73336,68731,28190,14701,13489,39214,17741,21473,44.6,106.7,67.1,34.0,33.2,"Schuylkill County, Pennsylvania",42107,19.84275025164183,27.60246925746303,42107,361.0,3.0
783,0500000US42129,"Westmoreland County, Pennsylvania",350611,171859,178752,64119,32808,31311,108895,48343,60552,47.4,96.1,69.3,38.4,31.0,"Westmoreland County, Pennsylvania",42129,18.28778903114848,31.05863763544213,42129,1012.0,4.0
784,0500000US45083,"Spartanburg County, South Carolina",313888,151082,162806,72372,35802,36570,70165,31339,38826,38.0,92.8,64.0,26.2,37.8,"Spartanburg County, South Carolina",45083,23.056631664797635,22.35351462942196,45083,943.0,6.0
785,0500000US48339,"Montgomery County, Texas",590925,294399,296526,155734,80924,74810,109427,51389,58038,37.5,99.3,65.6,22.0,43.7,"Montgomery County, Texas",48339,26.35427507720946,18.51791682531624,48339,1913.0,17.0
786,0500000US51087,"Henrico County, Virginia",329261,156568,172693,74468,38107,36361,72311,29972,42339,39.3,90.7,62.0,25.4,36.6,"Henrico County, Virginia",51087,22.616708325614027,21.96160492739802,51087,1031.0,5.0
787,0500000US51760,"Richmond city, Virginia",228783,107729,121054,39707,19556,20151,43488,18237,25251,34.0,89.0,44.0,19.0,25.0,"Richmond city, Virginia",51760,17.35574758614058,19.008405344802718,51760,1612.0,5.0
788,0500000US55035,"Eau Claire County, Wisconsin",104534,52101,52433,20982,11122,9860,22432,10314,12118,34.5,99.4,56.3,25.0,31.4,"Eau Claire County, Wisconsin",55035,20.07193831671992,21.459046817303463,55035,661.0,3.0
789,0500000US55063,"La Crosse County, Wisconsin",118230,57208,61022,23383,11680,11703,26891,11941,14950,36.5,93.7,56.1,25.3,30.9,"La Crosse County, Wisconsin",55063,19.777552228706757,22.74465025797175,55063,656.0,2.0
790,0500000US01003,"Baldwin County, Alabama",218022,105437,112585,47156,24391,22765,59517,27487,32030,44.0,93.7,72.5,35.2,37.3,"Baldwin County, Alabama",01003,21.62900991643045,27.298621240058342,01003,398.0,4.0
791,0500000US05125,"Saline County, Arkansas",121421,59537,61884,28207,14248,13959,28369,12889,15480,39.2,96.2,70.0,30.5,39.5,"Saline County, Arkansas",05125,23.230742622775303,23.364162706615822,05125,244.0,2.0
792,0500000US12009,"Brevard County, Florida",596849,289611,307238,109627,54317,55310,191416,87156,104260,47.2,94.3,72.5,40.8,31.7,"Brevard County, Florida",12009,18.367627322823697,32.071093358621695,12009,1768.0,11.0
793,0500000US17091,"Kankakee County, Illinois",110024,54768,55256,25195,13449,11746,25626,12343,13283,37.5,99.1,65.5,27.6,37.9,"Kankakee County, Illinois",17091,22.899549189267795,23.291281902130446,17091,468.0,2.0
794,0500000US18005,"Bartholomew County, Indiana",82753,41162,41591,19690,9426,10264,18148,8240,9908,37.2,99.0,67.1,27.4,39.8,"Bartholomew County, Indiana",18005,23.793699322078957,21.930322767754642,18005,198.0,1.0
795,0500000US18057,"Hamilton County, Indiana",330086,160882,169204,89053,45029,44024,58564,26480,32084,37.7,95.1,65.3,20.7,44.6,"Hamilton County, Indiana",18057,26.978726756057515,17.742042982737832,18057,577.0,6.0
796,0500000US19153,"Polk County, Iowa",487204,240482,246722,121315,61891,59424,87921,39298,48623,35.8,97.5,60.9,20.8,40.1,"Polk County, Iowa",19153,24.900247124407844,18.046034104810303,19153,1820.0,8.0
797,0500000US20209,"Wyandotte County, Kansas",165324,81865,83459,46120,23453,22667,29070,12871,16199,34.3,98.1,67.2,20.6,46.7,"Wyandotte County, Kansas",20209,27.896736106070502,17.58365391594687,20209,1232.0,4.0
798,0500000US22045,"Iberia Parish, Louisiana",70941,34109,36832,18154,9176,8978,15241,6987,8254,37.4,92.6,67.3,24.5,42.8,"Iberia Parish, Louisiana",22045,25.590279246134113,21.484050126161176,22045,211.0,3.0
799,0500000US22103,"St. Tammany Parish, Louisiana",258111,126257,131854,61900,32383,29517,61068,28079,32989,40.8,95.8,69.2,28.6,40.6,"St. Tammany Parish, Louisiana",22103,23.981930254812852,23.65958831665446,22103,946.0,11.0
800,0500000US24001,"Allegany County, Maryland",70975,37941,33034,12257,6723,5534,18384,8464,9920,42.3,114.9,59.2,31.7,27.5,"Allegany County, Maryland",24001,17.269461077844312,25.90207819654808,24001,451.0,2.0
801,0500000US25005,"Bristol County, Massachusetts",564022,273114,290908,116098,59117,56981,134679,60310,74369,40.9,93.9,59.7,26.9,32.9,"Bristol County, Massachusetts",25005,20.583948853058924,23.87832389516721,25005,1399.0,8.0
802,0500000US26021,"Berrien County, Michigan",154141,75406,78735,33571,16844,16727,42824,19134,23690,42.1,95.8,71.1,33.8,37.3,"Berrien County, Michigan",26021,21.779409761192674,27.78235511641938,26021,512.0,4.0
803,0500000US26093,"Livingston County, Michigan",191224,95923,95301,40751,21031,19720,48246,22831,25415,44.0,100.7,62.9,28.2,34.7,"Livingston County, Michigan",26093,21.310609546918798,25.230096640589046,26093,177.0,2.0
804,0500000US26103,"Marquette County, Michigan",66516,33223,33293,12450,6380,6070,17746,8803,8943,39.0,99.8,61.3,31.1,30.2,"Marquette County, Michigan",26103,18.717301100487102,26.679295207168202,26103,289.0,2.0
805,0500000US29019,"Boone County, Missouri",180005,87634,92371,36539,19657,16882,32208,14288,17920,30.4,94.9,48.1,18.1,30.1,"Boone County, Missouri",29019,20.29888058665037,17.892836310102496,29019,620.0,4.0
806,0500000US34031,"Passaic County, New Jersey",503310,245652,257658,119860,61205,58655,103780,46286,57494,37.4,95.3,62.2,23.6,38.6,"Passaic County, New Jersey",34031,23.814349009556736,20.619498917168347,34031,1456.0,5.0
807,0500000US35043,"Sandoval County, New Mexico",145179,71165,74014,33582,16953,16629,35389,16033,19356,40.9,96.2,69.1,30.0,39.1,"Sandoval County, New Mexico",35043,23.131444630421754,24.37611500285854,35043,271.0,2.0
808,0500000US36093,"Schenectady County, New York",155350,76212,79138,33337,17539,15798,38121,16516,21605,39.8,96.3,63.2,28.2,35.0,"Schenectady County, New York",36093,21.459285484390087,24.538783392339877,36093,538.0,3.0
809,0500000US37031,"Carteret County, North Carolina",69524,34225,35299,12343,6820,5523,23217,10582,12635,48.9,97.0,75.0,43.9,31.1,"Carteret County, North Carolina",37031,17.753581497036993,33.39422357746965,37031,135.0,1.0
810,0500000US37155,"Robeson County, North Carolina",131831,64164,67667,32772,16868,15904,29016,12898,16118,36.9,94.8,66.5,25.1,41.4,"Robeson County, North Carolina",37155,24.85909990821582,22.009997648504527,37155,452.0,1.0
811,0500000US39133,"Portage County, Ohio",162927,79341,83586,29604,15313,14291,38216,17584,20632,39.1,94.9,53.5,25.6,27.9,"Portage County, Ohio",39133,18.170100719954334,23.45590356417291,39133,302.0,1.0
812,0500000US41047,"Marion County, Oregon",346868,174987,171881,85970,44449,41521,76684,35399,41285,36.8,101.8,67.2,25.8,41.4,"Marion County, Oregon",41047,24.784644302731877,22.10754523334525,41047,496.0,4.0
813,0500000US42027,"Centre County, Pennsylvania",162805,85370,77435,24527,12469,12058,31484,14684,16800,31.6,110.2,41.0,19.8,21.2,"Centre County, Pennsylvania",42027,15.065262123399158,19.338472405638647,42027,438.0,3.0
814,0500000US42125,"Washington County, Pennsylvania",207346,101092,106254,40241,20001,20240,58284,26813,31471,44.3,95.1,65.9,33.7,32.2,"Washington County, Pennsylvania",42125,19.40765676694993,28.109536716406392,42125,602.0,4.0
815,0500000US45059,"Laurens County, South Carolina",66994,33066,33928,14560,8287,6273,17111,7711,9400,41.5,97.5,68.3,31.7,36.6,"Laurens County, South Carolina",45059,21.73328954831776,25.54109323222975,45059,76.0,1.0
816,0500000US47001,"Anderson County, Tennessee",76482,36937,39545,16147,7891,8256,21083,9912,11171,42.9,93.4,69.8,34.0,35.9,"Anderson County, Tennessee",47001,21.112157108862217,27.565963233179048,47001,301.0,1.0
817,0500000US51085,"Hanover County, Virginia",107239,52446,54793,23714,12521,11193,26431,11890,14541,42.8,95.7,65.9,29.2,36.7,"Hanover County, Virginia",51085,22.113223733902778,24.64681692294781,51085,265.0,2.0
818,0500000US53035,"Kitsap County, Washington",269805,138086,131719,55256,28388,26868,66244,30952,35292,39.2,104.8,61.8,28.6,33.1,"Kitsap County, Washington",53035,20.479976279164582,24.552547210022052,53035,381.0,3.0
819,0500000US55055,"Jefferson County, Wisconsin",85129,42442,42687,18054,9325,8729,20450,9937,10513,42.1,99.4,62.4,27.9,34.4,"Jefferson County, Wisconsin",55055,21.207814023423275,24.02236605622056,55055,82.0,1.0
820,0500000US55087,"Outagamie County, Wisconsin",187365,92975,94390,44127,22158,21969,39072,18343,20729,38.2,98.5,62.0,23.8,38.2,"Outagamie County, Wisconsin",55087,23.551356977023456,20.853414458410054,55087,517.0,3.0
821,0500000US01049,"DeKalb County, Alabama",71385,35048,36337,17145,8965,8180,17182,8407,8775,39.5,96.5,70.0,29.2,40.8,"DeKalb County, Alabama",01049,24.01765076696785,24.069482384254396,01049,134.0,1.0
822,0500000US06007,"Butte County, California",231256,113736,117520,46212,23211,23001,58620,26448,32172,37.5,96.8,62.6,30.1,32.5,"Butte County, California",06007,19.983049088456085,25.348531497561144,06007,592.0,7.0
823,0500000US06017,"El Dorado County, California",190678,94527,96151,38012,18699,19313,57738,27580,30158,46.6,98.3,69.9,36.0,33.9,"El Dorado County, California",06017,19.935178678190457,30.280367950156812,06017,240.0,3.0
824,0500000US06025,"Imperial County, California",181827,93655,88172,50831,26087,24744,31908,13522,18386,33.1,106.2,69.2,21.9,47.3,"Imperial County, California",06025,27.955694148833782,17.548548895378573,06025,268.0,2.0
825,0500000US06029,"Kern County, California",896764,459769,436995,258952,131665,127287,143202,66168,77034,32.0,105.2,66.1,18.2,48.0,"Kern County, California",06029,28.876270679911325,15.968749860609927,06029,1833.0,15.0
826,0500000US06041,"Marin County, California",259666,127299,132367,51861,26557,25304,78465,35517,42948,47.4,96.2,73.6,38.9,34.7,"Marin County, California",06041,19.972195050564956,30.217664230203418,06041,458.0,4.0
